s,p,sent,s_freq,p_freq,freq
2.5007447220000785,2.433130867999985,abductor,998,1004,2002
0.647059641999931,4.06812155800008,aborigine,354,2697,3051
2.7940653400000315,3.988965960000023,abstainer,164,426,590
0.6924566019999432,3.9106873420000383,accumulator,2194,469,2663
2.142046801999939,3.9365376499999982,achiever,577,1612,2189
2.606085624000073,3.120501859999912,acquaintance,13178,9081,22259
2.6921362280001233,3.8755411599999974,addict,12455,18953,31408
2.197976709999942,3.612062438000116,adherent,2216,12743,14959
2.1286006919999636,2.6439369620000477,administrator,61210,57008,118218
2.8353448699999504,2.963756326000045,admirer,6444,6882,13326
2.7066440860000327,4.102713632000018,adolescent,26820,18675,45495
1.3835416819999722,3.838662218000028,adult,245407,211316,456723
2.372488527999927,3.4644412639999516,adventurer,6950,8770,15720
2.383616595999989,3.5588185619999493,adversary,14726,15142,29868
2.483660241999928,3.2942774440001017,advocate,129120,169090,298210
2.6679509820000398,2.603420800000002,agent,296265,259730,555995
0.12448145999999838,3.750287926000098,aggregator,5228,2317,7545
1.356425850000008,2.9915853539999873,agonist,4617,3250,7867
2.3477110860000323,3.7831740619999437,albino,4706,945,5651
2.5295177960000643,3.0298563359999164,alien,134423,59864,194287
0.4182970739999021,3.863943855999942,allocator,2767,684,3451
3.5409899479999467,3.814948240000014,amputee,2353,1728,4081
3.095834912000008,3.370157180000085,analyst,140326,139030,279356
2.3259645940000553,3.4680981779999627,anarchist,44060,26033,70093
3.503266456000013,2.5494375079999685,anatomist,758,396,1154
2.5194427579999683,3.8027911819999787,ancestor,16543,40028,56571
2.852444052000081,2.51594033199995,angel,71285,52496,123781
1.650026486000037,4.049825408000043,animal,376786,323086,699872
3.2423030160000295,2.5793881720000655,animator,8445,7778,16223
2.6755062119999593,3.233575650000077,antagonist,12276,6215,18491
3.212674942000099,2.8562176500000547,antiquarian,1833,197,2030
3.7109407420000196,2.4072311220000486,antiquary,125,240,365
3.0937787600000632,3.560481927999952,ape,11422,13950,25372
2.905178387999946,3.169339897999997,apologist,4324,8652,12976
3.092743787999993,2.885202135999961,apostate,2730,2622,5352
2.3773181860001174,3.7656970379998853,applicant,21197,49503,70700
2.8771823300000605,2.8975751180000273,appointee,7152,11733,18885
1.2573902099999543,1.4932966020000222,appointment,84329,30798,115127
2.6603834100000867,2.715004638000039,arbiter,7407,2643,10050
3.387594997999983,3.329690389999989,archer,21385,4952,26337
3.355814475999999,3.2214658699999106,architect,56275,39639,95914
3.843523786000027,3.893540205999976,aristocrat,2937,4228,7165
3.460639611999916,2.679281226000029,artificer,1139,313,1452
3.0287360460000166,3.6516945939999452,artist,229336,212484,441820
3.978443969999894,3.3466984979999737,ascetic,3489,753,4242
3.728069343999991,3.9048850339999746,aspirant,1909,1896,3805
1.6298971139999523,3.3997270539999036,assignee,421,164,585
2.4997210200000026,2.744018146000002,assistant,282156,21877,304033
2.584167611999902,2.795761366000029,associate,161000,55860,216860
3.522439905999775,3.7159378999999646,astronaut,28563,39886,68449
2.7736043639999224,4.108258533999923,athlete,58866,116006,174872
0.19252417800004196,3.2740538379999435,attraction,52751,22535,75286
3.3136171420000267,3.3483053459999823,author,463215,225163,688378
0.7614911019999511,2.008531444000049,authority,381264,501897,883161
2.7207032299998914,3.743186067999993,automaton,3080,3462,6542
2.182988598000044,4.063220565999998,baby,297082,89352,386434
0.018532408000076828,2.948602110000003,balance,328654,26376,355030
3.590386750000029,3.658071808000024,banker,22058,45232,67290
3.606009637999925,3.3595363240000324,barbarian,8538,5867,14405
2.604712726000031,3.4185891819999767,beast,77081,21937,99018
2.675491743999906,2.571447927999948,beater,2111,1081,3192
1.9633667699999364,3.390202820000013,beginner,14917,14870,29787
2.086471815999971,3.008597782000038,beholder,1326,155,1481
2.3081926080000557,2.9052291659999625,being,5830771,92990,5923761
3.1733477120000018,3.4796590139999637,believer,23513,32466,55979
4.562057703999962,3.7405101559999068,billionaire,71829,22891,94720
3.3079077799999936,2.964833065999997,biologist,26008,18230,44238
2.5750793660000966,3.1208285079999314,biter,532,306,838
0.9597465879999234,2.684197542000014,bleacher,9033,3998,13031
2.9470072400000618,3.5977883060000337,blogger,48537,30692,79229
3.3663804079999124,3.350673653999955,boater,621,2345,2966
0.7835614380000209,3.4447784239999493,body,1036949,241587,1278536
4.06302624599995,3.381590048000014,bodybuilder,2626,2937,5563
2.8427289800000324,3.29955372400012,bomber,44275,38056,82331
1.7875069700000523,2.97685793199998,bookmaker,1363,2639,4002
1.888472662000055,4.062548547999981,boomer,6703,15065,21768
0.9416875740001132,3.3269262019999317,booster,26185,10990,37175
3.0429398819999136,2.940740459999965,boss,180377,48969,229346
1.7095255600000243,3.351488489999973,broadcaster,35350,20661,56011
1.909727617999991,3.9465569359998725,brunette,5020,294,5314
2.8281286320000305,3.1699840560000325,buddy,39376,17096,56472
1.3373481799999567,1.9358714499999508,buff,22085,12139,34224
2.610193707999919,2.9520188940000622,builder,27762,25069,52831
3.1006149119999478,3.4320506599999305,bull,79088,72714,151802
4.192006548000052,3.3015691819999944,bullfighter,442,157,599
2.476526645999975,3.5989471239999276,businessperson,803,3522,4325
3.7021237720002134,2.8070335419998003,busker,699,641,1340
2.6004560780000006,2.8161085600000106,buster,11618,2333,13951
2.875095916000017,3.875593625999926,candidate,506899,347570,854469
2.7807229220000664,3.6640923299999315,capitalist,88834,20133,108967
3.9462524239999652,3.3200370900000067,captain,253483,16668,270151
2.161611741999941,3.8328328939999494,captive,29473,7587,37060
2.6692017099998893,1.8732180019999305,captor,1436,5759,7195
0.7209641660000301,3.790112832000027,carrier,98127,59639,157766
1.932455252000075,2.976809531999969,cashier,7243,2111,9354
2.0067938019999616,3.92377118600011,castaway,1763,1674,3437
-0.17531419599995957,3.571388044000045,category,169959,93878,263837
3.2341310720001317,3.7433763860000298,celebrant,799,1211,2010
3.1535133260000805,3.2427491100000196,challenger,40310,14137,54447
3.0728842219999564,3.70317101200002,champion,203122,176920,380042
2.1839983139999433,2.8985865800000497,changer,7475,2584,10059
2.323817532000021,3.8975380959999733,character,690363,486749,1177112
3.0747380439999503,3.0646085440000377,charmer,1023,292,1315
1.1795345060000102,4.048974116000046,cheerleader,7129,7446,14575
1.4391019859999759,3.909531364000159,chicken,149491,26550,176041
3.705904013999973,3.4947559560000414,chief,930238,83614,1013852
4.313452329999926,3.2990792580000843,chieftain,3107,1644,4751
2.175643340000086,4.0303007840000085,child,741674,1313110,2054784
2.994652692000116,3.0152578799998366,choreographer,2818,642,3460
2.5267608940001054,3.322670499999937,chum,2631,1083,3714
2.2719401679999933,4.110028639999939,citizen,148173,424169,572342
2.3324355159999755,3.893811850000027,claimant,5792,11538,17330
-0.5530952079999665,3.941724927999907,class,913518,202635,1116153
2.6190112219999477,3.393699955999999,classmate,11363,21505,32868
1.1678078339999942,3.9812774700000304,client,217687,162342,380029
3.4509925780000046,3.4186605279999327,climatologist,2607,1710,4317
2.6477348119999817,3.083258520000001,clone,43670,14859,58529
2.598576588000064,3.8902794440000505,coder,3689,5606,9295
2.547516115999997,3.0210848520000866,collector,30236,26981,57217
2.36436010200007,3.3233312040001195,comer,3027,1884,4911
3.9846861179999955,2.889886285999957,commander,156018,42244,198262
3.587217160000151,3.113990888000025,commentator,34298,43224,77522
3.071053790000043,3.380579715999936,commoner,1658,2323,3981
2.0257477660000376,3.330035683999924,communicator,3732,1930,5662
1.4727530420000647,3.4707671820000314,companion,58412,22314,80726
3.237403212000018,3.216771039999962,compatriot,3854,5766,9620
-0.27276052600007006,2.746959242000038,competition,333569,30010,363579
2.0566530239998997,4.155008686000066,competitor,38460,70055,108515
0.6159737720000322,3.9957523840000206,computer,562607,147007,709614
3.55175572000001,3.227249327999992,comrade,11084,21797,32881
4.19143995200001,2.895041921999969,confessor,1359,345,1704
3.3973667599999686,2.8253308379999353,confidant,5843,1721,7564
1.6241609100000574,3.7576515859999873,congener,131,343,474
2.278433146000012,3.056734650000024,conservative,585591,202174,787765
2.255775623999952,1.843546971999956,conservator,1620,1052,2672
0.7987873100000016,4.355649373999981,consumer,297398,260356,557754
1.3037885220000405,2.891042932000076,contemporary,152691,9638,162329
2.502525338000126,4.290134556000005,contender,41063,30134,71197
1.5497814220000379,4.292344681999978,contestant,14077,19782,33859
1.6701394160000547,3.0735137639999053,contractor,51364,57007,108371
1.20213506999999,3.508010088000013,controller,96056,37150,133206
2.1771176020000453,3.6508134759999464,coon,3524,3142,6666
0.9037864619999922,3.271468120000044,copycat,5793,1331,7124
4.02556796999999,3.88787657200006,cosmonaut,3588,2930,6518
3.2712532720000667,3.862048857999895,cottager,50,492,542
0.6084134000000248,2.800089738000068,counter,183062,23621,206683
2.923197634000026,3.363440946000047,cousin,49538,40521,90059
2.143822773999986,3.406027666000014,crab,18863,8318,27181
1.265859643999967,3.27088219999996,crawler,4268,2353,6621
2.92445169800002,3.1887775419999755,creator,102790,75996,178786
2.2218784939999985,3.424890640000047,creature,108032,110048,218080
1.5510303900000935,3.278443311999922,creditor,5230,21247,26477
3.6980506160000033,3.064126069999972,cripple,10583,1534,12117
2.649713025999965,2.9904881480000896,crony,8187,6419,14606
1.3170037920000226,3.949350838000015,crossbreed,466,137,603
3.4615293439999917,3.4524972679999806,crusader,12713,10185,22898
2.677856366000036,2.630311873999908,cultist,1507,2684,4191
2.3535972699999803,4.120448161999974,dancer,15972,17784,33756
2.6593945180001057,3.6072996359999507,debater,1370,1468,2838
3.4524658359999023,3.074730366000047,defender,117539,86322,203861
2.5362389640001126,3.614421207999989,deist,675,476,1151
3.702239302000045,3.256174450000046,demigod,1481,711,2192
3.0839220940000125,2.660492155999986,demon,40968,30127,71095
2.8758145320001063,3.38375755200007,denier,4148,7311,11459
2.9220113079999663,3.6106957479998485,denizen,1204,6409,7613
2.2508434740000354,3.7487111979999455,descendant,10774,30422,41196
2.3638070779998657,3.576922360000104,descendent,2026,2185,4211
3.9781619620000015,3.703459008000003,deserter,1184,1974,3158
2.645332708000005,2.989362128000053,designer,117125,79755,196880
1.500810349999952,2.9725889220000425,developer,220575,332059,552634
3.092820438000153,3.1589056199999987,devotee,3495,8903,12398
4.485289154000057,3.43785152400001,dictator,31781,10532,42313
0.26858224000003617,4.3735999620001,diploid,1343,49,1392
3.6286093400000965,2.9397909759999834,director,1075374,90402,1165776
4.019004770000016,3.307685733999989,disciple,8693,15346,24039
3.5688556580000537,3.5320088179999303,discoverer,2175,959,3134
2.663297349999965,2.82800327799999,dissenter,1161,5676,6837
0.8135770879999811,3.3526522419999765,distributor,18499,19609,38108
3.377702251999956,3.2877552439999675,diver,9079,15982,25061
0.9451358819999811,3.0519055179998773,divider,2823,1424,4247
2.7074490900000967,3.539650164000136,doer,1249,966,2215
2.9176410739999667,3.2737241819999667,doubter,421,5095,5516
3.0469325760000032,3.792058437999998,dreamer,4988,8658,13646
0.973946837999982,3.0575793960000937,dresser,3907,673,4580
3.5744176019999543,2.4613738979998985,dribbler,548,180,728
3.03779751800003,3.6933410280000487,driver,331017,250280,581297
1.5523799420000302,3.373998505999971,dropout,7558,3230,10788
1.4042577139999892,4.10696995200005,dupe,3183,1850,5033
3.598615125999995,2.9457841759999894,dwarf,36582,8124,44706
3.0181991940001254,3.491289789999982,dweller,2203,8112,10315
2.1800113759999746,3.959247927999968,dynast,162,168,330
4.040469860000044,2.774968731999955,elder,73271,24336,97607
3.4253000280000307,3.1587415020001544,emcee,2590,827,3417
2.3775968000000347,3.477238307999972,employee,200643,435134,635777
0.997274030000014,3.647291182000025,employer,69758,113415,183173
2.032229963999903,3.5564575779999714,endorser,887,910,1797
0.16739511199992307,3.3545559559999845,enemy,258760,159377,418137
0.570816201999996,3.8756510980000343,engine,306340,90589,396929
3.4340625340000415,2.6429579879999636,engineer,122504,134789,257293
2.5430959199999705,4.155071659999969,enrollee,1408,6384,7792
3.8321470639999617,3.3101917280000706,entertainer,6554,5577,12131
0.20810187399997204,2.167044054000101,equal,301687,32146,333833
1.0519035880001084,3.7602370219999983,estimator,1851,812,2663
0.5076257719999901,4.318335243999918,eukaryote,343,1452,1795
1.093693444000003,3.3020683240000395,exchanger,1553,879,2432
3.209287030000077,2.3195813499999645,executioner,4454,1712,6166
2.743491916000117,2.5092176680001472,executor,3148,1341,4489
2.113089106000025,3.2927288019999565,experimenter,4456,3031,7487
2.655335525999945,3.0671307840000637,expert,230712,352516,583228
3.2153433300000174,3.8375523719999194,explorer,45025,14386,59411
3.1810860920000508,2.5404308720000017,exterminator,867,416,1283
2.840054452000082,2.971935354000003,extremist,63574,44445,108019
1.0191197260000209,3.226570314000085,face,1141842,268846,1410688
0.6570243860000105,2.135162672000071,failure,319477,64079,383556
-1.7426247320000634,4.501608467999937,family,1698371,468573,2166944
1.026554857999983,3.1827039120000933,fan,390877,819281,1210158
4.045906615999932,3.8325346080000244,farmer,55493,170886,226379
0.8195921779999864,2.493492463999928,fastener,1008,1482,2490
1.8829470280000393,3.1601632360000096,favorite,566791,39200,605991
1.6049138619999255,3.2664181620000647,federalist,10773,1911,12684
4.535329497999939,2.551163616000018,fella,3341,2032,5373
4.040262923999958,3.0669303879999816,fellow,403431,11927,415358
3.7278862940000437,4.255252714000001,fencer,2674,1738,4412
0.8346458119999198,3.7438536319999756,feudatory,49,48,97
3.6517484400000058,3.7768112940000123,fighter,161699,199203,360902
1.427114691999975,2.5486989440000656,figure,760376,348399,1108775
4.2762187939999805,3.4640591600000903,financier,7841,7358,15199
1.6666689399999726,2.960047903999964,finder,9627,1779,11406
2.6948642500000375,3.6356488879999773,finisher,7080,4879,11959
2.107260531999927,3.3222411299999237,flatmate,794,544,1338
1.4890729860000107,2.4565150539999863,flier,6759,9655,16414
0.7620958139999061,1.8675487840000784,flyer,16207,40549,56756
1.5502004600000276,3.1531980580000507,foe,16945,21576,38521
1.5888127200000497,3.124094547999995,follower,14780,106645,121425
4.270630843999925,3.195372751999976,fool,42080,15039,57119
3.242653537999992,3.3625214440000093,foreigner,10236,48499,58735
1.0990032880000697,3.330316948000032,forerunner,6863,2052,8915
2.1435531460000306,3.8354896580001068,freelancer,5327,6525,11852
2.5069484080000564,3.5165378299999475,friend,541766,796235,1338001
2.985241940000023,2.9928900339999913,fucker,1628,1415,3043
3.673954196000068,3.3859838200000425,gambler,3822,5009,8831
2.5498453039999944,2.878635357999997,gatekeeper,4921,5440,10361
1.7764364559999564,3.4290486520000556,gay,422991,33016,456007
3.3597671039999426,2.812450366,genealogist,458,369,827
2.0211340760000667,3.2773552959999606,gentile,5383,3576,8959
3.942688339999968,3.0877643640000656,geographer,2438,1059,3497
3.7663157479999683,2.9523454659999686,geologist,7670,6851,14521
2.474414063999916,3.225287744000042,giant,323138,137928,461066
2.5851926460000243,3.521065684000007,giver,3634,1963,5597
2.4931046939999817,3.504326211999974,goat,28023,15779,43802
3.5609780180000286,2.450901124000005,goon,3769,5611,9380
2.473109130000033,3.82911441600001,grownup,1128,1312,2440
2.328991069999958,2.6640326319999943,guardian,142509,35886,178395
2.064731899999991,3.2658663019999423,guerilla,6257,1046,7303
2.17613552199996,2.806810200000001,guide,288542,46739,335281
0.7660086679999836,3.128208710000038,gutter,5070,1861,6931
2.656169110000043,3.177584558000042,hacker,53067,77753,130820
0.5690269799999754,3.0014350740000637,hanger,4473,2044,6517
2.588810427999995,3.048571773999896,hater,2711,9670,12381
2.043672552000043,3.2956034259999996,head,1389552,220981,1610533
1.3334071359999626,3.332406333999927,hearer,582,674,1256
0.8371580499999851,3.461130401999874,heathen,3771,1468,5239
3.1142379519999537,3.690919572000098,hedonist,452,258,710
1.773366205999956,2.9494164540000156,helper,18222,8071,26293
2.3344756600000807,3.5860351439999647,hobbyist,3975,4615,8590
2.3636052139999677,3.749028302000042,holder,71229,57763,128992
2.92787913000015,3.915426002000075,holidaymaker,299,2009,2308
2.34458706599996,3.9078450180000175,homeowner,15601,37775,53376
2.641576168000057,3.247397827999933,homosexual,44888,16051,60939
3.0073453780000463,3.2308081740000247,horticulturist,359,181,540
2.783024489999928,2.918380665999912,host,454280,106233,560513
2.5729172599999757,3.880236826000079,householder,2735,1649,4384
2.250829857999939,3.2938313280000173,hugger,466,363,829
2.23311722199999,3.135856269999998,humanist,14279,3985,18264
4.097273721999983,3.3118793980000376,humorist,1233,277,1510
2.2066609039999676,4.074540353999943,humpback,5221,1022,6243
3.4263764079999355,3.453344778000073,hunter,101381,42584,143965
1.0987304059999161,3.6936693780000596,hybrid,94391,11371,105762
2.7203771779999357,3.844153739999939,idealist,3203,2080,5283
3.3953742539999965,3.3069454299999848,idiot,21041,13299,34340
2.572628052000013,3.843761912000005,idler,712,308,1020
3.7121630200000766,2.5813980639999556,illusionist,982,282,1264
2.6760154420000646,3.2228792299999824,imitator,409,1880,2289
1.2101340539999654,3.532178098000145,independent,576562,27512,604074
1.5299320620000216,3.80543756400003,individual,735597,492543,1228140
2.631743854000028,3.731264284000062,individualist,4331,1058,5389
2.887621418000002,3.3348020179999693,informant,16362,9681,26043
2.5683980680000076,3.5313278440000104,initiator,2547,1247,3794
2.608096674000066,3.3290076160000552,instigator,2678,1448,4126
2.931325030000032,2.9036021099999445,insurgent,19540,26709,46249
1.7593967920000537,3.8597382619999934,intellectual,168356,22698,191054
2.5790770920000057,3.157958539999889,interloper,1159,1148,2307
1.9610189760000907,3.519961816000027,internationalist,4415,900,5315
2.6735473220000117,2.778367760000016,investigator,48561,196321,244882
2.507749332000074,3.742863919999941,investor,74569,234503,309072
2.7889012000001188,3.5451462619999603,islander,5961,28312,34273
2.36622539399999,3.378776798000011,isolationist,3955,596,4551
3.0331338580000065,2.825712847999956,judge,592105,144717,736822
3.7611882340000165,3.1247394419999637,jurist,3458,3323,6781
2.6778431920000187,3.6203058779999893,juvenile,47332,10197,57529
3.5453360980000035,3.6349507499999945,kid,188924,557940,746864
2.681288838000029,2.062968362000035,kidnapper,1640,4212,5852
3.2974080299999926,3.449943129999994,killer,112088,27958,140046
1.349182003999907,2.332053151999915,knocker,371,288,659
3.7234898359999633,2.99839320199996,lawgiver,440,118,558
4.1758931419999215,3.1381829079999406,lawmaker,33866,211575,245441
1.031585930000169,3.3622098899999386,layperson,1085,1586,2671
3.5470243019999614,3.690463127999923,leader,762448,678185,1440633
1.8586927880000275,2.7814465859999515,leech,6040,2231,8271
4.855466936000013,2.51839130000004,lefty,14605,6811,21416
1.3879941159999944,3.3824202780000334,liberal,401555,136494,538049
3.020056385999993,3.2971705860000355,libertarian,87027,28531,115558
4.009859628000065,3.619858735999884,libertine,1260,569,1829
3.4374011419998496,3.054334831999988,linguist,5220,5323,10543
3.233507625999941,3.3147949879999956,lion,52581,97033,149614
2.731752140000019,3.2618813980001278,liquidator,704,1129,1833
0.6959109959999097,3.28924760999989,listener,21817,35683,57500
2.645742410000139,4.099144916000029,litigant,1055,2550,3605
3.920186677999901,3.476419777999965,logician,624,692,1316
3.0653276199999624,2.990979402000093,logistician,120,174,294
3.0692227100000267,2.9196765160001092,looker,596,118,714
1.6155612220000535,4.452948202000101,loser,19871,24029,43900
-0.15584527399997938,3.713396565999993,lot,2775567,360227,3135794
4.371454438000036,2.925242519999955,lout,400,349,749
3.021983266000028,4.0751503779999965,lover,30166,36505,66671
3.6022512600000525,3.487671666000047,lunatic,8770,2652,11422
0.8052567019999941,3.4903508620000423,machine,382474,163748,546222
0.4573420260000063,2.170843055999903,mailer,4892,2509,7401
1.7513735760000273,3.089919972000075,maker,79167,84270,163437
2.351392726000036,3.1411903999999637,manipulator,3795,1858,5653
3.131204044000114,3.9025928020000578,marcher,864,9530,10394
3.6984029939999274,3.096710270000038,master,263405,79403,342808
2.557394888000097,3.1203563319999645,mate,60970,20464,81434
3.950264164000025,3.2969590819998587,materialist,4999,806,5805
2.846661594000004,2.714537238000055,mentor,36788,11416,48204
3.510086302000026,3.124855306000036,mercenary,14516,12564,27080
3.8395677159999835,3.3358983180000124,metallurgist,274,203,477
2.7806263379999123,2.883381988000103,midget,4102,721,4823
2.844430323999994,3.6441099339999425,migrant,56757,118605,175362
2.355001086000037,3.3407986819999422,militarist,1473,638,2111
2.5940623739999893,3.5891654299999516,millenarian,684,56,740
4.086147718000014,3.8213069640000015,millionaire,14951,12219,27170
3.305052626000034,2.9438029320000467,mineralogist,205,50,255
2.449093499999975,3.6767664620000957,minor,273713,30644,304357
2.8884968699999405,3.571826869999974,misfit,3680,6568,10248
3.713079365999924,3.0472663360000993,missionary,21192,16467,37659
0.8794945660000693,3.916591779999962,model,800618,319129,1119747
2.317041314000015,3.240363611999932,modeler,1193,1821,3014
2.7392159679998755,3.270340662000045,moderationist,6,9,15
0.6748828220000362,2.716424315999994,modifier,14462,6303,20765
2.4279103420000325,3.6539499499999906,moneymaker,955,281,1236
2.287778366000012,3.4262866500000513,monster,139425,74076,213501
3.65331024999999,3.314812460000134,moron,3656,3454,7110
2.7052517779999192,3.154572535999961,mortal,34611,5028,39639
3.653583752000138,3.268264619999968,motorcyclist,3729,3308,7037
3.681174203999916,3.916097010000037,mountaineer,2238,3974,6212
1.6044129759999848,4.391449666,mouse,106737,105286,212023
2.5804546580000576,3.3433711880000274,mover,5738,6198,11936
3.6564247460000416,3.611524487999958,murderer,18445,12226,30671
4.319897539999928,3.6658154699999344,musher,346,429,775
2.208753632000011,3.3092267919999188,mutant,28804,11040,39844
0.24758168800003943,3.571793344000099,national,2686417,66786,2753203
2.87729675799995,2.9946775859999946,nationalist,71245,25989,97234
2.0731249679999735,3.4322834079999183,native,367344,19769,387113
2.069837328000027,3.642930093999915,naturist,2096,789,2885
2.8986972940000015,3.190155537999864,navigator,8245,2491,10736
3.163452275999923,3.7942902939999996,negotiator,11606,18663,30269
2.4476494800000097,3.1917070880001006,neighbor,58872,97443,156315
2.356389425999943,3.210284480000105,neighbour,19344,34003,53347
3.3195810259999803,3.4542379579999647,nerd,18717,12080,30797
2.220388584000041,4.263527131999929,nestling,1074,595,1669
3.010597872000048,3.2020151659999883,nihilist,1490,751,2241
2.312655785999901,3.781036058000005,nonconformist,751,255,1006
2.5116239759999317,3.9540850900000564,nudist,3149,1128,4277
2.9068483440000463,2.904169347999904,numismatist,257,248,505
2.1859902120001493,3.559950409999992,objector,1500,2098,3598
2.47105630800003,3.3556991800000304,observer,54918,73140,128058
3.496498245999881,2.727442508000017,occultist,1324,875,2199
2.2255285579999935,3.605428119999992,occupant,6825,15213,22038
2.081147272000102,3.4509987359999883,occupier,2003,8418,10421
3.440673691999997,3.3442611380000784,oceanographer,1999,690,2689
3.0204370459999836,3.14842318799991,oddball,5621,672,6293
2.423698729999977,3.664848582000019,offender,28947,47808,76755
2.0787705399999936,2.6535897460000157,official,1022849,1170063,2192912
2.6966487820000538,3.050036250000069,oiler,1102,23280,24382
2.1043277220000434,3.2305209320000188,operator,91301,91222,182523
1.4563261899999844,3.435804548000114,opponent,176745,207959,384704
0.8692235059999689,4.122879160000032,organism,18722,38223,56945
2.740360041999949,3.320453599999972,originator,3938,1812,5750
2.2230888199999796,3.6002472060000272,orphan,12912,7628,20540
3.367190444000059,3.352664204,outcast,5159,2635,7794
4.13055273799997,3.337010965999987,outdoorsman,743,292,1035
2.657062367999977,3.1607374339999623,outsider,21009,24531,45540
2.8278462800000455,2.4080017279999666,overlord,7333,4437,11770
2.6604019020000145,3.1890585040000268,owner,329155,309636,638791
2.8984661579999837,3.7432893079999303,pacifist,6077,1463,7540
2.978379696000033,3.072810320000009,pal,19389,10973,30362
3.1221310439999286,3.344608661999928,palaeontologist,1164,980,2144
3.326396372000019,3.1115846080001077,paleontologist,4025,4084,8109
1.7548674339999764,3.3885188699999915,pansy,988,299,1287
3.360303994000077,3.7323808539999987,parachutist,464,296,760
3.522434774000061,3.1984926539999705,paraplegic,1175,328,1503
1.3917583360000378,3.2101413960000045,parasite,14368,13015,27383
0.7386152860000124,4.104674858000003,parent,167159,605176,772335
3.3584889779999543,3.230824644000002,parliamentarian,5506,8360,13866
2.6284336179999457,3.4823876239999976,parrot,11545,4788,16333
1.580522378000012,4.552661244000024,participant,43546,255180,298726
0.37117627799993613,3.5482552459999823,partisan,74546,9746,84292
1.4434447100000227,3.8524815339999066,partner,294528,213400,507928
-0.7113529619999746,4.36580257,party,1679913,387168,2067081
2.3520253740000427,3.8840741559999827,passenger,117560,144367,261927
3.425838022000015,3.0168154979998505,passer,22013,3532,25545
2.3242397599999514,4.199344195999942,patient,214098,448648,662746
3.5248870059999433,4.030685261999977,patrician,1992,524,2516
0.9929289339999059,4.501061071999928,payer,8917,4738,13655
2.401841392000044,3.7844371659999823,pedestrian,44929,30149,75078
2.276397872000018,3.33358938800005,peer,64685,59742,124427
3.326636368000102,3.45525710000004,perfectionist,2644,654,3298
2.7994318540000407,3.7014387679999885,performer,26881,36524,63405
1.4731997479999954,3.743743490000071,person,1285464,9341934,10627398
2.849023392000049,2.653811079999919,personage,1032,892,1924
1.2152729479999707,3.0400019779999923,personification,4186,471,4657
1.7577968019999801,3.6273227240000736,pet,107029,37318,144347
4.227364419999937,3.484069720000001,philosopher,36863,29693,66556
4.397371940000028,3.2639525979999178,physicist,27884,23343,51227
1.4147621419999652,3.1070435579999796,picker,4337,2498,6835
4.247951649999962,2.698114287999971,pitcher,63997,41173,105170
0.4189211580000247,4.297181735999914,planet,242895,69186,312081
2.2123021220000325,3.3375620759999762,planner,15635,26112,41747
0.15798314199996355,4.01604810399995,plant,341368,238723,580091
2.4568821620000705,3.672662432000024,planter,3121,3766,6887
3.580391532000135,2.955127422000075,plantsman,13,1,14
1.5734052080000502,3.858426931999972,player,1194193,1628482,2822675
2.3105350759999794,3.7311345679999732,pleaser,548,183,731
2.452982662000011,3.656899193999976,plebeian,978,444,1422
2.8908554620001183,2.967752076000018,plotter,1030,3492,4522
3.1360112019999775,2.72690636199993,poisoner,330,218,548
3.5367408339999855,3.659478193999888,politician,85261,277559,362820
0.3413760380000852,4.282531621999929,polyploid,207,78,285
2.9388370919999787,3.562286754000006,possessor,1679,826,2505
1.267167387999912,2.4428421059999508,poster,78313,50297,128610
4.277854171999934,3.2574842280001093,potentate,345,461,806
2.8906634600000203,3.1731218459999724,pragmatist,2078,1175,3253
1.0147416980000301,1.5822032999999252,prayer,91560,52708,144268
0.7734568740000611,3.458527862000011,predecessor,32632,17158,49790
3.3507455640000288,3.9347794280000628,prisoner,54598,123489,178087
0.25330055000003426,4.112735576000119,processor,69608,34350,103958
2.7221094960000656,2.363878678000056,producer,174531,129671,304202
2.0952019659999976,3.094121812000054,professional,473027,99041,572068
2.514832430000041,3.922391096000105,profiteer,651,1852,2503
2.5671986059999767,3.316547330000013,programmer,33606,38023,71629
1.7015233720000111,3.3610495779999354,progressive,225347,36828,262175
0.5246488079999878,4.518631875999922,prokaryote,139,639,778
3.0067028580000184,2.8237210580001033,propagandist,3413,4275,7688
2.70735027200017,2.9789533620000057,propagator,445,362,807
3.9866796720000437,2.840097359999959,prophet,63528,13896,77424
2.1799133999999185,3.1360844159999814,proponent,18988,48141,67129
2.1342426539999977,2.725209182000043,prospect,172517,108779,281296
3.355615125999954,3.8406626119999103,protagonist,34384,12718,47102
2.184138207999915,3.58763069999992,protectionist,8002,387,8389
3.201525159999953,3.3749319420000035,protester,24545,230790,255335
2.182053030000077,3.055400911999996,publicist,7827,1620,9447
4.2839902500000235,3.682457853999942,pugilist,604,199,803
2.283837158000125,2.6899839419999623,puller,1055,424,1479
3.9852109379999376,3.4819901160000697,punter,7839,4391,12230
2.06229899800001,3.8341266559999383,pupil,14328,30410,44738
3.0957359640000703,2.821234748000009,pursuer,774,1324,2098
1.8942098679999475,3.4253064879999755,pussycat,921,366,1287
1.462685126000025,3.752468476000047,pygmy,3611,1081,4692
0.47012072999996946,3.189237689999999,qualifier,22921,16741,39662
1.8053351359999468,3.156125148000015,radical,223315,20367,243682
0.4234804120000959,2.807124837999943,rafter,766,3559,4325
2.270507725999984,4.0238709539999284,rat,46030,57252,103282
2.5960256900000047,3.2276052200000294,rationalist,3321,1348,4669
2.182949707999967,3.5599617939998893,raver,552,763,1315
1.3270584460000237,3.1856868339999593,reader,147724,242637,390361
3.1657357140000357,3.1904868099999533,realist,6623,2829,9452
1.9014968160000194,3.5564816519999525,receiver,134662,52650,187312
1.7836558460000091,3.8789240739999897,recipient,42592,44845,87437
1.1047587980000273,3.7344616160000896,rectifier,838,211,1049
4.262684155999928,3.7038870299998763,recusant,74,45,119
0.7469950620000674,2.128139694000005,referral,17288,8921,26209
3.60714490600008,3.6070140120000715,reformer,4929,12259,17188
2.250875795999974,3.2426212940000383,reformist,9514,2543,12057
3.1425745539998005,2.6970273000000304,regent,9097,9268,18365
2.08592919599991,3.894084958000228,registrant,2429,2355,4784
0.37715997400001555,3.1132784380000302,regular,549196,11849,561045
0.22339406000002526,3.1136100999999385,relative,254163,84651,338814
0.8624151139999015,2.453063957999994,relict,508,111,619
3.471935937999902,3.0619149760000255,renegade,10140,4109,14249
0.8323378619999104,3.092753962000046,repeater,2657,1060,3717
0.9780560239999474,2.979856393999995,replacement,143318,15227,158545
2.716778042000051,3.2618222119999913,reporter,211728,263164,474892
2.429058879999964,3.3205369279999815,representative,228263,198721,426984
2.4803523260000304,2.4130905280000547,rescuer,1864,12757,14621
2.2968078159999905,3.386120247999976,researcher,112724,586536,699260
2.517612148000076,3.860018295999943,resident,168263,452813,621076
2.2148587819999648,3.9490823700000774,resister,418,1559,1977
3.28462649800003,4.135753870000009,respondent,10520,91738,102258
1.7230669119999362,2.8587883779999856,retainer,2601,1285,3886
2.9552669339999156,2.88258391800003,revenant,3238,576,3814
2.532624797999972,3.2773981360000732,revolutionary,152328,14010,166338
3.3076374919998557,3.1094400640000543,revolutionist,354,428,782
2.511466980000016,3.6683549339999573,rider,59330,89015,148345
2.3468548720000726,2.610579875999953,ringer,3878,796,4674
0.8739678980000747,2.9094341780001187,riser,2631,1671,4302
1.6577845999999568,4.151763183999961,rival,145754,80130,225884
0.9192836859999787,2.5516985619999772,rock,405818,77990,483808
2.7621725120000065,3.365157275999948,romanticist,156,55,211
1.6576735640002056,2.4278967300000573,rounder,4276,1024,5300
3.601802348000046,3.310174803999999,ruler,29619,28332,57951
2.810823751999962,3.8803765119999554,runner,56065,44130,100195
2.673145018000014,3.650421214000005,runt,1168,220,1388
3.5948214440000186,2.844827273999975,sacrificer,48,23,71
3.6885496979999672,3.4245152259999756,saint,91005,82850,173855
1.8043254959998691,3.198068562000074,salvager,183,249,432
3.532815536000008,2.876072518000079,salvor,110,90,200
0.5623214580000351,4.033596649999943,satellite,155698,48295,203993
2.220465873999956,4.0942658879999385,saver,5048,6053,11101
1.380901225999935,2.444298048000043,scab,1708,1427,3135
2.985632924000022,2.5473014240000396,scalawag,102,157,259
2.770374075999996,3.2422880719999654,schemer,957,592,1549
3.6108423839999872,2.8946309900000102,scholar,98726,92386,191112
2.4972430560000873,3.6042250420000315,schoolfriend,141,109,250
2.5624633879999834,3.151073301999908,schoolmate,794,1297,2091
3.4196263380000076,3.408577039999983,scientist,137342,480352,617694
2.70872270000001,2.755331994000059,scorpion,9151,4417,13568
3.5373154979999484,2.6960271220000465,scout,58697,49365,108062
1.9899469679999768,2.969712686000065,screamer,1129,447,1576
1.058895906000032,2.896635470000099,scrubber,735,659,1394
2.4115371500000506,3.3824934239999678,searcher,1362,4092,5454
1.5200793320000372,3.4663105460000665,secessionist,3825,1180,5005
2.033129398000007,3.4214321619999595,secularist,2688,3366,6054
3.1674982160000127,3.4158933939999585,seeker,14349,43675,58024
3.337018703999888,2.4718632420000617,seer,5043,1303,6346
3.5895551319998873,3.60481118200007,senior,697277,38826,736103
2.1470138600000155,2.9287399519999724,separatist,23189,19388,42577
3.1135639020000596,2.9682614480000282,servant,28622,36695,65317
2.4369506480000567,2.910060332000022,shaker,6143,2982,9125
2.343748528000013,2.9161015319999777,shark,59423,53805,113228
2.6806992699999768,3.7109749620000443,shipowner,154,324,478
3.7906783959999863,3.251991983999929,shooter,74637,28729,103366
0.4461452740001306,4.0808573360000295,sibling,15055,32713,47768
3.8829038100000233,3.1562684399999554,signaller,198,145,343
2.2156553880000445,3.8942996839999893,signatory,6274,11312,17586
3.4749981940000865,3.8051128619999233,signer,2372,3843,6215
1.75772495799999,3.2412726420000055,sitter,2794,1094,3888
2.68537875800002,4.269360292000016,slave,77530,57420,134950
3.388622950000105,2.60567384999991,slinger,671,410,1081
4.065417803999949,2.6650566160000153,smith,384577,4840,389417
2.652046544000129,3.2533231879999533,snake,53335,22641,75976
3.5961226980001086,3.6438738259998757,snowboarder,1465,1328,2793
1.8541198459999961,2.690955166000009,source,890627,469592,1360219
4.998940020000035,2.1167810259999698,southpaw,3860,562,4422
1.6992169279998635,2.0568914080000624,spade,5482,3970,9452
1.1494078200000004,2.4653643140000625,spearhead,6754,1048,7802
2.593547031999961,2.57659999600007,specialist,80426,36213,116639
0.3931277099999093,2.8779097520000008,specifier,832,467,1299
2.1052924059999327,3.8103253019999883,spectator,16339,21772,38111
2.6844898120000025,3.3979058740000028,speculator,1487,9186,10673
2.1076701799999995,3.1674294139999972,sphinx,5208,516,5724
1.245369205999907,3.202152523999999,splitter,4739,775,5514
1.0554412139998774,2.6140058679999996,spoiler,30630,20296,50926
1.2693641899999335,3.6949945780001343,sponsor,65597,48205,113802
0.6212316539999776,2.159159851999938,sport,216777,541162,757939
2.5519421259998722,2.436959336000058,spotter,2500,1804,4304
1.1418497319999616,4.593963141999971,spouse,28673,17571,46244
2.869786024000021,3.5475297599999855,star,832762,308789,1141551
2.4765470620000016,3.130304373999927,starter,85343,36256,121599
2.977486762000048,2.9098690899998942,stooge,1785,3452,5237
3.4482792920000414,3.174778733999915,stranger,68755,41913,110668
2.4639510659998862,3.3072035060000857,strikebreaker,49,459,508
4.775392350000082,4.069082767999987,striker,69432,18984,88416
2.432910892000045,3.2688756760000075,stringer,5289,610,5899
1.9517247099999793,3.4584332380001186,stripper,4903,3000,7903
2.3349080179999504,3.9329804920000164,student,633815,1072692,1706507
2.3997015119999823,4.359609570000018,subject,536422,145054,681476
2.4572351760000117,3.1564261899999693,substitute,66352,11268,77620
1.618188654000015,3.145805523999961,successor,51431,9675,61106
2.479956620000003,3.9251745440000008,sufferer,2950,9269,12219
1.2421997139999092,4.706510013999953,suffragist,554,679,1233
2.3513458559999165,2.36289829800004,superior,142577,11679,154256
1.503967935999988,3.3002004640000138,supernumerary,526,36,562
3.917217198000067,3.6473458619999803,supplicant,541,424,965
2.121400466000061,3.1919424719999867,supporter,87759,395558,483317
1.2001404379999983,2.4248273659999313,suppressor,3720,1854,5574
3.0670535539999975,3.0383842780000236,supremacist,28433,16498,44931
2.6815487400000464,3.1075634359998787,surveyor,4009,2572,6581
2.9640000400001156,3.3137745159998886,survivalist,2191,786,2977
2.076533548000043,3.896732533999913,survivor,47669,77634,125303
3.668721823999988,3.404695407999995,suspect,265635,114292,379927
3.3798779780000245,4.26744564599997,swimmer,8628,9263,17891
2.3591725499999114,3.0652052759999364,sympathizer,2118,6120,8238
2.50764763199993,3.5927985779999503,syndicalist,1840,683,2523
3.7631832879999934,3.038836223999944,tactician,2485,597,3082
3.5552378159999733,3.0072632380000215,tapper,10213,288,10501
2.647738613999941,2.2375289580001265,technician,18692,18233,36925
2.7796950299999565,3.219240589999906,technocrat,1427,2899,4326
2.947070257999968,3.1681634280001205,technologist,3736,4906,8642
3.584513441999988,3.5102781759999218,teen,102085,67591,169676
3.461278524000001,3.730833096000019,teenager,65603,60055,125658
3.5339674080000805,4.189389401999904,teetotaler,257,154,411
3.0148646800000307,3.075624072000039,terrorist,295416,128203,423619
3.6621621540000433,3.2071781020001,theoretician,771,1015,1786
2.9910591040000014,3.3726221780000003,theorist,12554,21680,34234
2.219560304000076,2.6798310579999622,therapist,22777,12271,35048
3.3449387419999894,3.633495592000024,thinker,10763,24490,35253
3.5574870420000053,2.8100181080000084,thrower,3746,1729,5475
2.8928676720000084,3.241444636000054,tiger,63185,68687,131872
3.199189805999964,2.8245986079999525,tinker,12559,896,13455
0.3766619060000238,2.9808473620000413,tool,328637,374721,703358
1.6186888979999452,3.1914388180000444,topper,2650,1031,3681
2.923161515999972,3.488236109999953,torchbearer,582,392,974
2.445419143999885,3.6689668340000523,tourist,69399,74148,143547
2.57407153799997,2.477338266000089,trainer,37221,22594,59815
0.7608546180001028,1.9259713279999602,transfer,291347,51871,343218
2.8314445800000527,3.184333731999942,transvestite,1334,528,1862
2.811962876000038,3.766765802000002,traveler,13161,39453,52614
3.0410372899999274,3.7443526919999783,traveller,8445,18084,26529
2.4328620920000787,3.018982372000032,trespasser,779,1158,1937
2.299806366000098,2.5612085600000114,trimmer,1631,588,2219
3.6433809600000586,3.1226838779999966,troublemaker,1592,2295,3887
2.511799185999976,2.722286422000053,trustee,14256,22130,36386
2.9679636039999338,2.6287927780001112,turner,65756,643,66399
0.6187854759999851,3.593326884000035,twin,110730,48276,159006
3.2395843420000148,3.2000089720000204,unbeliever,630,2403,3033
2.319282660000056,3.1505719719999945,unionist,11967,7396,19363
0.6556527040000297,3.97810961200004,user,607411,799952,1407363
2.241911477999885,3.9101687580000615,vacationer,148,1255,1403
2.060585978000063,3.9620372400000434,vassal,3515,2024,5539
4.24970009999997,3.2407642300000035,veteran,213943,170551,384494
2.5313527459999605,4.0689260859999905,victim,271100,366143,637243
2.6883834880000776,3.8179011540000047,victor,66979,3566,70545
0.6478359119999979,3.500437802000093,viewer,44091,140540,184631
3.0033721539999902,3.234375772000085,villain,42564,27904,70468
2.075788305999957,3.3919734660000387,visitor,41692,162009,203701
2.240574866000003,3.8527824899999743,volunteer,97390,115630,213020
2.608677681999943,4.259142450000013,voyager,16471,1146,17617
1.9132146499999436,3.2710654240000068,walker,133753,9551,143304
3.820705745999959,3.5046084439999277,wanderer,2932,9060,11992
3.3089801280000444,3.4452957239999407,warmonger,1082,1394,2476
3.705664206000016,3.3715509080000245,warrior,61742,100220,161962
1.0523474699999866,2.9288651439999995,washer,4666,2466,7132
1.2231870399999778,3.1857309480000566,wasp,9809,7184,16993
2.2210359560000015,3.0150919640000424,watcher,5626,14120,19746
1.4401798560000003,3.395007248000013,waver,2382,854,3236
3.237988655999928,3.4108054459999693,westerner,1642,11961,13603
2.5230460119999663,3.712898299999978,whale,50883,37849,88732
1.636322700000001,4.419068759999952,winner,192575,95521,288096
1.2775590080000399,2.6343888500000503,wiper,2178,1507,3685
2.9722433780000443,3.468486847999962,witness,166055,123495,289550
2.5184174299999498,3.842511338000076,worker,175313,755287,930600
2.182460970000001,3.0359713200000016,workmate,215,672,887
2.6685677200000057,3.1791970799999945,worshiper,638,3727,4365
2.7490376740000286,3.2748860979999677,worshipper,1261,7898,9159
4.077793295999996,3.6791602459999666,wrestler,20026,15836,35862
3.2675579420000247,3.0063582939999733,writer,293224,186923,480147
2.4548384139999655,3.403010813999998,wrongdoer,402,1190,1592
4.164517128,3.5212070660000094,youngster,16268,25665,41933
2.20681825999997,3.469362624000027,youth,277574,28938,306512
3.3740891859999635,2.9546898000000468,zealot,4735,7341,12076
2.1483233520000695,2.914433973999955,zombie,67293,36298,103591
2.0232540659999145,3.046830015999994,zooid,52,119,171
