ss,pp,sent,s_freq,p_freq,freq
3.7590491790771523,2.767221672058106,abductor,15,19,34
3.448479072570798,2.7722735671997043,aboriginal,830,72,902
3.936877792358402,2.7589602279663126,aborigine,20,235,255
3.02382253265381,2.2812917709350415,absentee,111,6,117
3.207005180358891,1.9841165008545047,abstainer,4,4,8
3.719726058959978,2.026387779235847,accumulator,26,24,50
4.157562873840327,2.702557403564448,accuser,39,38,77
3.585416213989255,2.105462982177727,ace,1494,295,1789
4.168166130065913,2.231033851623536,achiever,25,6,31
3.4661037521362275,2.225560356140136,acquaintance,373,218,591
3.668645225524905,2.7994410171508832,actor,8770,6109,14879
3.7489506530761716,2.2918039093017555,actress,5705,614,6319
3.636839439392098,2.248816963195793,addict,145,72,217
3.449918746948242,2.618208534240722,adherent,66,352,418
4.106574432373051,2.6582533569335993,adjudicator,11,5,16
4.02957498168945,2.334583770751962,administrator,782,492,1274
3.562255538940427,2.272725402832016,admirer,270,182,452
3.351986038208004,2.9408215942382867,adolescent,335,209,544
3.6956078033447355,2.781966758728018,adult,5529,3574,9103
3.572136039733877,3.0634189147949016,adventurer,192,152,344
4.1393939361572265,2.599070983886719,adversary,196,197,393
3.5872068099975536,2.0778979949951264,advocate,1365,653,2018
3.994313034057619,2.771987251281743,agent,5241,3117,8358
3.6750395355224583,2.367082794189457,aggregator,443,12,455
3.357141868591306,2.9975176239013734,agnostic,128,33,161
3.9118341903686513,1.9961415328979513,agonist,74,65,139
3.0998661422729583,1.7991440124511797,albino,85,11,96
3.8761514663696346,2.997228340148922,alchemist,112,43,155
3.6078765945434625,2.835022071838381,alien,3286,1309,4595
3.7189962463378947,1.7043172531127908,allocator,40,39,79
3.2971464233398393,2.480483024597177,amateur,2233,232,2465
4.111857482910153,1.5250551300048727,amir,541,4,545
3.481458145141602,2.1119663238525206,amputee,59,28,87
4.220107688903795,3.1771485900878957,analyst,462,549,1011
3.6574879989624023,2.6454208526611325,anarchist,566,321,887
3.836911834716794,2.2629594192504925,anatomist,72,47,119
3.4070044479370125,1.9057500381469623,anatomy,1085,3,1088
3.5495662689208984,2.407581336975099,ancestor,931,1088,2019
3.152124977111818,2.2327306518554693,ancient,6622,134,6756
3.9005782623290983,1.9825840988159271,angel,2602,1354,3956
3.3362701492309554,2.9506744537353526,animal,5978,7775,13753
3.8735532608032273,2.4139631652832065,animator,391,736,1127
3.619611763000485,2.3305226211547776,announcer,324,99,423
4.2358279647827075,2.770521957397463,antagonist,884,345,1229
3.9241649703979533,2.642492698669443,antiquarian,296,37,333
4.0394907608032256,2.4470655212402335,antiquary,61,75,136
3.7988938751220687,2.646705192565925,ape,207,372,579
3.5856657714843863,2.4123295593261744,apologist,31,24,55
3.719474983215335,2.682348495483396,apostate,27,9,36
4.0868115997314405,2.902423866271974,applicant,269,385,654
3.87506896209716,2.4040914230346715,appointee,73,147,220
3.4291345520019547,1.76754415130614,appointment,2742,656,3398
4.248924255371094,2.909682586669902,arbiter,248,22,270
3.722067810058597,2.766237159729002,archer,950,324,1274
3.714960182189934,3.0329329147338697,architect,2373,1256,3629
4.413371307373048,2.675027748107908,archivist,71,13,84
4.005573379516598,2.4872902069091793,aristocrat,138,191,329
3.8241727905273493,2.5566645812988185,artificer,12,7,19
3.779878616333008,2.6297415542602636,artist,9094,7385,16479
3.478340324401863,2.5912265014648383,ascetic,142,50,192
3.5077351455688586,2.886614860534678,aspirant,29,15,44
3.9697286682128947,2.4510625839233313,assignee,10,5,15
3.372034477233889,2.6337769012451133,assistant,5266,498,5764
3.2794156723022425,2.292528831481931,associate,1675,1268,2943
3.1359853057861287,2.2407562637329193,asthmatic,33,5,38
3.913814910888668,2.7049553375244244,astronaut,433,438,871
4.011108039855962,2.8768607940673903,athlete,1335,2410,3745
2.972840713500979,2.54196308135986,attraction,1582,735,2317
3.939195968627928,2.327560600280762,auditor,184,97,281
4.088288085937499,3.159903892517093,author,7640,3461,11101
3.707130989074713,2.858271415710462,authority,7524,5340,12864
3.607476074218752,2.074392921447739,automaton,39,43,82
4.101602462768547,2.178196418762191,avatar,888,182,1070
3.7048485946655276,2.1496357574462905,baby,4303,480,4783
2.970662902832032,0.8739854965210085,balance,2775,122,2897
3.854354782104487,1.7209087600707846,banker,372,252,624
3.4611258468627923,3.0220095977783146,barbarian,318,163,481
3.669699684143069,2.5215643539428783,bather,7,25,32
4.347961067199705,2.1127803268432643,bearer,374,150,524
4.095418312072752,2.356637435913086,beast,1214,238,1452
3.971958763122558,2.682406112670904,beater,46,11,57
3.537350746154793,2.2358635330200087,beginner,59,78,137
3.7366602859497036,2.3512924118042093,behemoth,83,3,86
3.9670219497680748,2.852139465332044,beholder,54,3,57
3.2006250839233346,3.3358054275512714,being,69128,978,70106
3.6898057250976564,3.0786536483764593,believer,355,228,583
3.4476442718506064,2.261303009033199,belligerent,111,42,153
3.270894607543937,2.3114385757446314,beloved,547,4,551
4.114969177246088,2.3484754333496056,benefactor,187,94,281
4.188676307678222,2.761779731750508,bidder,118,56,174
3.9597831802367978,2.4252556991577023,billionaire,174,31,205
4.011268013000475,3.0187675933837923,biologist,293,237,530
3.5018152465820407,2.6336348114013646,bisexual,298,9,307
4.040931358337396,1.4284782485961927,biter,12,4,16
3.0188259887695352,1.7462314071655243,bleacher,42,88,130
3.421549301147465,2.506649002075193,blogger,162,89,251
2.874784255981446,1.2723127059936488,blonde,641,31,672
3.538236167907712,2.5170603408813577,boater,9,57,66
4.006442596435548,2.2065593566894535,boatman,23,25,48
3.6610429916381904,2.5722101440429697,body,17987,5562,23549
3.9714796752929686,1.7928918075561597,bodybuilder,30,5,35
3.8072504730224637,2.7198804626464934,bomber,2167,2884,5051
3.725491645812994,2.3440728759765506,bondsman,3,5,8
2.6559906387329306,1.3593812789916981,boob,11,18,29
3.5216349411010697,2.693628616333015,bookmaker,37,73,110
3.347969413757312,2.8800570068359406,boomer,66,27,93
3.49816408538819,2.4458536376953077,booster,281,98,379
3.857374732971188,2.501261795043945,boss,2156,471,2627
3.591770355224604,2.4921385650634775,bowman,455,22,477
3.304286102294917,2.2476039962768652,boxer,550,129,679
4.329795806884761,2.7318936080932588,boy,7855,4928,12783
3.352338592529293,1.9537527770996093,boyfriend,1689,74,1763
3.4016334609985392,2.1897483901977495,brawler,28,5,33
3.954347282409664,2.547268692016601,broadcaster,515,297,812
3.0049366455078115,3.328210632324229,brother,12442,6567,19009
3.3046970214843725,2.500419029235843,brunette,74,5,79
3.3883821563720744,2.27837046051026,brute,186,45,231
3.3486054077148424,2.4203356246948147,buddy,424,46,470
2.9634763412475564,2.083685127258306,buff,458,42,500
3.813659118652339,2.618355812072757,builder,492,431,923
3.3072634735107442,2.3623806838989267,bull,1696,585,2281
3.938415557861326,2.221447761535643,bullfighter,18,5,23
3.022442573547366,2.1547951278686526,bum,81,24,105
3.9172035446166973,2.2939713897705047,businessperson,16,37,53
3.8850185775756785,2.332030471801758,busker,7,3,10
3.1964367370605373,2.685639739990229,buster,238,265,503
3.9779392776489217,2.40158587646485,caliph,564,52,616
3.9538499984741193,2.3531686706542985,caller,146,39,185
4.002251701354993,2.6589325637817325,candidate,4275,2755,7030
3.776737915039064,1.8149042510986533,capitalist,358,85,443
3.966312774658199,2.6320031738281244,captain,13626,805,14431
3.4524988021850618,2.728827377319334,captive,1064,352,1416
4.101554100036623,2.7595380020141604,captor,36,210,246
4.236086296081538,2.242932723999033,caregiver,173,125,298
4.177837120056154,2.7941586608886695,carrier,3591,2397,5988
3.899058784484872,1.8356282424926746,cashier,63,6,69
4.194711364746105,2.8609916992187507,castaway,36,34,70
3.882096282958969,2.0982190093994078,caster,29,9,38
3.465645355224609,2.4896216812133787,catalyst,402,145,547
3.232407081604002,2.6243510818481326,category,6389,1759,8148
3.6236478347778274,2.6842288360595674,caveman,20,21,41
3.9725722274780324,3.0516602554321395,celebrant,13,3,16
3.7159025726318475,2.471314506530746,censor,285,313,598
3.2174522933959935,2.497235153198247,centrist,68,7,75
3.8289729385375963,2.3914806289672867,centurion,169,43,212
4.240404136657709,2.5844722290039073,challenger,456,153,609
3.760993225097657,2.706524246215821,chameleon,74,27,101
3.5828157348632743,2.4664554824828997,champion,5322,4183,9505
3.6614634628295875,2.2695761566162105,changer,48,22,70
3.943430274963376,2.767717079162601,chap,46,23,69
3.9957099533081006,2.9618108215332057,character,34343,20753,55096
4.166173545837395,1.5245235977172769,charmer,33,6,39
3.6327599258422794,2.3730998764038134,cheerleader,180,94,274
3.7498005371093726,2.7629046630859335,chemist,427,188,615
3.260980873107904,2.545099662780764,chicken,1204,264,1468
3.4536440734863305,2.2183765640258812,chief,12922,1421,14343
4.017553482055668,2.519261001586912,chieftain,219,180,399
3.7876643447875864,2.979972663879394,child,10686,22791,33477
3.793317359924309,2.4507356185913096,choreographer,343,68,411
3.7373145065307583,2.404875350952132,chum,50,12,62
3.996418037414543,2.581721855163579,churchgoer,12,20,32
3.8724726028442475,2.7081126861572287,citizen,1644,4207,5851
3.8092842254638697,2.730582794189452,claimant,322,157,479
2.759802070617681,2.539287117004406,class,22588,3889,26477
3.404161338806155,2.3085920562744136,classmate,285,358,643
4.597455093383786,2.0860117568969656,client,849,738,1587
3.9803059616088774,2.994216865539542,climatologist,5,11,16
4.026104263305669,2.2006399154663114,clone,530,430,960
3.031322692871086,1.8200214309692413,closer,3303,30,3333
4.008253822326651,2.61394689941406,coder,5,8,13
3.701450912475579,2.178055694580074,collector,1208,673,1881
3.687845710754395,3.03913249206542,combatant,110,295,405
3.5641832809448175,2.9397340087890598,comer,60,26,86
4.014168464660649,2.595224128723153,commander,11359,1979,13338
3.7780830764770528,3.2043739395141557,commentator,705,1446,2151
3.9339238128662117,2.380657127380374,commoner,103,226,329
3.952966743469233,2.202006584167485,communicator,55,23,78
3.602090995788565,2.7153775787353567,companion,1945,908,2853
3.731137580871575,2.8969498596191485,compatriot,106,120,226
3.253619834899901,1.7479799880981375,competition,8431,1677,10108
4.04045442962645,3.0364758987426725,competitor,670,1164,1834
3.400790390014649,2.7223922500610414,computer,6158,1189,7347
3.7372954254150343,2.868931732177728,comrade,138,420,558
3.7905843429565422,2.0956792373657294,confessor,201,12,213
3.766993103027346,2.1207844314575155,confidant,112,27,139
3.3337497634887683,2.5733036880493216,congener,28,32,60
3.8048135223388755,3.280526542663573,conquistador,73,91,164
3.1608726730346746,2.5469607772827203,conservative,3913,1056,4969
3.818512870788581,2.3673048782348616,conservator,35,47,82
3.2821270217895417,3.0972366790771417,consumer,1085,700,1785
2.5972791290283226,2.9419987640380896,contemporary,7271,1034,8305
4.027045333862304,2.534992607116692,contender,690,440,1130
3.964738021850586,2.89473449707031,contestant,600,631,1231
3.42477600860596,2.811399223327655,contractor,517,456,973
3.8108786468505897,3.069744972229003,controller,1077,450,1527
2.788727226257322,2.7091160736084063,coon,178,31,209
2.8926961441039936,2.739091110229495,copycat,47,4,51
3.7939505844116184,2.3711475753784157,correspondent,740,161,901
4.058165428161615,2.026684806823731,cosmonaut,67,73,140
3.602016014099121,2.7722379837036186,cottager,4,12,16
3.261996925354005,1.5328012313842763,counter,3737,237,3974
3.8498369369506946,2.213707351684569,courier,460,52,512
3.6879861450195364,2.9721594696044917,cousin,2123,509,2632
3.3953783035278278,1.9480975189208891,coward,412,47,459
3.2728457565307565,1.7847218551635677,cowboy,511,523,1034
3.5331944122314454,2.6108075714111365,crab,499,351,850
3.739640304565434,2.1558978271484364,craftsman,132,259,391
3.2642677993774214,2.6093994369506746,crawler,42,21,63
3.5990773773193325,3.1894037704467877,creator,2950,871,3821
3.9600135116577135,3.2406552810668927,creature,1566,1534,3100
3.7740997772216716,1.919553474426273,creditor,49,282,331
3.4789085006713805,1.553000068664545,creeper,61,18,79
3.7584969482421826,-0.5637144241332948,cripple,127,24,151
3.349972465515137,2.423724807739248,crony,9,21,30
3.1434857788085893,2.636055061340336,crossbreed,15,11,26
3.3082226028442534,3.00473853302001,crusader,424,719,1143
2.5402766799926866,2.6240283279418932,cultist,4,22,26
3.0306857223510733,2.671229583740228,cyborg,102,17,119
3.5034531097412156,2.474556526184074,dancer,921,1857,2778
3.467652137756353,2.3110509872436467,darling,422,8,430
3.9609117355346726,2.958894309997561,debater,31,12,43
3.5676872558593615,2.0277884216308593,debtor,50,156,206
2.7912007369995138,2.4039028167724723,decoder,16,4,20
3.9642661285400393,2.6131798477172907,defender,1208,1711,2919
3.3710334320068256,3.0690416336059627,deist,23,23,46
3.8802802886962766,2.366433418273928,demigod,56,26,82
3.455113502502442,2.669755462646478,democrat,1048,2107,3155
3.7150982131957946,2.4441337966918937,demon,1286,830,2116
3.5069092025756703,2.6502780838012683,denier,26,74,100
3.7447271194457983,2.349462623596196,denizen,13,48,61
4.07047723388672,2.7690738906860304,descendant,584,1249,1833
3.48470414733886,2.643858161926275,descendent,53,64,117
4.223576637268074,1.8629052505493107,deserter,44,163,207
3.4824993057251064,3.046197807312012,designer,3003,1167,4170
3.361904670715319,2.808133506774901,destroyer,2451,2839,5290
3.712843223571781,3.101958892822246,developer,1287,2254,3541
3.686967788696286,2.615871147155765,devotee,164,289,453
3.95413655853271,1.7096169204711913,dictator,558,69,627
3.431422584533678,2.4710286788940294,diploid,102,3,105
3.8757724227905257,2.205096878051755,director,16935,2898,19833
3.6789538040161105,2.6223841476440413,disciple,228,397,625
4.050333404541021,3.0081932678222714,discoverer,126,90,216
3.5488057785034144,2.695751243591303,dissenter,42,264,306
3.6834393081664984,2.626456489562983,dissident,181,223,404
4.342139434814449,2.296448181152357,distributor,538,299,837
3.847360153198238,2.4443190307617186,diver,402,582,984
3.312003044128417,2.0585597152710022,divider,38,18,56
3.6213077850341833,2.500005546569824,doer,8,11,19
3.916893249511709,2.5480278396606337,doubter,3,20,23
3.1011385650634793,1.6826021347045952,drawer,85,25,110
3.7597487182617186,2.268359008789062,dreamer,189,102,291
3.6353681182861237,1.5859533920287987,dresser,116,15,131
3.6487477264404333,1.504016883850099,dribbler,13,3,16
4.17318896484376,2.1408383560180653,driver,3170,2734,5904
3.166596809387215,2.097768760681163,dropout,122,15,137
3.6263465881347656,2.40031269073485,dummy,280,88,368
3.8084761047363287,0.1983941726684577,dupe,16,5,21
3.697134780883779,2.624150947570797,dwarf,1530,191,1721
3.9820951919555654,2.541599525451659,dweller,49,146,195
3.9992798156738303,2.1517085647583087,dynast,18,10,28
3.737195960998527,2.5734658508300754,elder,2150,349,2499
3.677676666259771,2.738495384216307,emcee,24,12,36
4.273307312011724,2.0667877883911103,emir,290,77,367
3.640113998413092,2.619023773193362,employee,1165,3109,4274
3.7418960647582935,2.6901994323730563,employer,701,562,1263
3.7926641693115215,2.5220226287841854,emulator,40,12,52
4.208313072204589,2.483154716491697,endorser,28,15,43
3.991037200927728,2.4962332687377895,enemy,7687,3948,11635
3.3666747817993183,2.768805854797364,engine,7650,4212,11862
3.882194404602039,2.3282268142700318,engineer,4249,2635,6884
3.5722656784057634,2.5407946395874035,enrollee,3,7,10
3.951380180358889,2.0599658660888593,entertainer,392,198,590
3.822886825561511,2.3099502792358493,entrant,130,162,292
3.45220989990235,0.9823906021118205,equal,3697,361,4058
3.612861167907724,2.682899162292472,estimator,6,6,12
4.113439544677746,3.2794865112304734,eukaryote,14,223,237
3.542119308471676,2.491072723388669,ewe,73,102,175
3.9582537765502934,2.331569122314434,exchanger,18,24,42
4.045967811584475,2.4026485214233304,executioner,139,52,191
4.058738746643087,2.1435437774658297,executor,108,81,189
3.6264230270385696,2.630380920410147,experimenter,47,34,81
3.487137115478504,3.3589084548950225,expert,1548,1285,2833
3.8086158065796027,2.4457030639648423,explorer,919,491,1410
3.823167320251464,2.437430816650391,exponent,147,94,241
4.382946922302246,2.624647453308107,exterminator,13,10,23
3.0751016387939387,2.7543867797851647,extremist,114,105,219
3.299686286926267,1.45701610565186,face,10404,2002,12406
2.8329701461791927,1.1199225158691348,failure,5572,776,6348
3.1358943939208856,2.6066305923461996,family,35185,5277,40462
3.3134690322875855,2.719968345642087,fan,5086,10304,15390
3.808794097900389,2.196049102783199,farmer,1513,1784,3297
2.981752021789532,1.7712130355835,fastener,9,12,21
3.9393353195190315,1.768899665832521,father,22373,728,23101
3.4777488632202136,2.3061698532104487,fauna,657,37,694
2.918120368957524,2.9607471923828115,favorite,3764,451,4215
3.318588920593257,2.4166905670166017,federalist,332,206,538
3.9600518722534233,2.8119179534912178,fella,49,20,69
3.1379572372436613,2.7513167495727586,fellow,6041,492,6533
3.2907773056030294,2.8174584655761734,female,12596,4552,17148
3.85311618804932,2.513243370056152,fencer,41,8,49
3.656591110229485,2.422638839721685,feudatory,42,29,71
3.941123535156251,2.1488022766113204,fiddler,69,31,100
3.258469833374022,2.737349845886243,fighter,5058,3343,8401
3.980204498291009,2.4335854263305663,figure,7057,6255,13312
3.7607987976074213,2.3443655166625916,financier,159,84,243
3.9638792190551584,2.1937024993896728,finder,123,40,163
4.007369270324702,3.0730466842651296,finisher,218,162,380
3.0343618087768505,1.5958714218139676,flake,50,80,130
3.4955518646240193,2.584477790832537,flatmate,20,10,30
4.029906448364251,2.388117042541502,flier,38,84,122
3.5008835449218694,2.548120796203591,flora,883,18,901
3.63398525238037,2.4257624893188563,flyer,226,597,823
3.5023297882080016,2.8013048629760746,foe,270,292,562
3.9349461669921766,2.5088265609741214,follower,240,1792,2032
3.806152534484866,2.550370117187498,fool,558,220,778
3.9278546295166024,2.824154678344726,foreigner,132,542,674
3.617144309997556,2.426013153076184,forerunner,415,132,547
4.088304847717282,2.26834747314453,fox,8099,510,8609
3.8172424926757884,2.041341522216797,freelancer,63,18,81
3.895707389831543,2.650833595275884,freethinker,15,5,20
3.4151860809326138,2.766325225830073,friend,9824,10015,19839
3.9342165222168006,2.756137893676737,frogman,5,19,24
4.009326675415046,2.9344711456298853,fucker,9,5,14
3.5136763992309454,2.8262852935791045,fugitive,346,141,487
3.0798184738159193,2.3017684249877988,fuller,916,7,923
3.851370086669924,2.362869697570801,gambler,183,79,262
4.173069152832028,2.258206260681156,gatekeeper,94,14,108
3.593258232116696,2.6735364379882895,gatherer,53,118,171
2.757564239501953,1.789103942871094,gay,4156,174,4330
3.2690733795165983,2.8593307342529357,geek,285,60,345
4.025509262084945,2.9139209671020723,genealogist,41,16,57
3.329094314575194,2.660277648925785,genius,1206,75,1281
3.3524489212036173,2.4861268844604467,gentile,57,24,81
3.439627784729005,2.702047180175782,geographer,144,30,174
3.7758668899536048,2.807528205871577,geologist,232,183,415
3.1741606826782203,3.1091964187621954,giant,4076,3129,7205
3.8175103836059563,2.6386595535278303,girl,8590,5439,14029
3.8138998336791943,1.5622313308715832,girlfriend,1844,135,1979
3.534473335266121,2.131520996093741,giver,51,9,60
3.1622444152831903,2.2083143310546802,gladiator,221,137,358
3.1146770782470696,2.251349670410157,goat,456,327,783
4.104833740234376,2.2614028549194245,goon,52,38,90
2.9957587890624993,2.8520506896972506,great,31055,109,31164
4.09742141723634,2.803526924133301,grownup,5,8,13
2.9886056747436527,0.3391620407104483,grunt,86,103,189
3.791497200012209,2.0741071701049805,guardian,3158,442,3600
3.074855232238761,2.801195533752434,guerilla,100,42,142
3.002701019287116,2.771645828247074,guerrilla,627,350,977
3.414300224304206,2.0774891128540034,guide,4317,735,5052
3.641703742980944,1.8849306564331059,gull,180,169,349
4.074012222290037,2.0471726913452244,guru,332,97,429
3.1031287384033206,1.6252342910766515,gutter,56,40,96
3.634721794128417,2.5128469467163086,hacker,216,83,299
2.8094503250122074,0.8642989959716942,hanger,51,35,86
3.6408342590331984,2.219968574523925,hater,31,58,89
3.408851081848134,1.488778518676753,head,21431,4830,26261
4.147705329895011,2.393041778564452,headman,34,23,57
3.690411346435546,2.3575617065429597,healer,107,29,136
4.191308540344238,2.5437366943359336,hearer,7,14,21
3.516647232055668,2.4804647674560556,heathen,173,82,255
2.9338809509277297,2.504479774475115,heavyweight,1820,25,1845
3.8480945587158146,2.6537582015991177,hedonist,6,5,11
3.783427253723154,2.006686027526868,helper,298,120,418
4.024777282714844,2.822432197570805,hero,5235,1872,7107
3.0080634536743105,3.12670441436768,heterosexual,280,24,304
3.264887481689456,3.0660895004272675,hobbyist,20,52,72
3.864918304443357,2.686654556274405,holder,707,609,1316
3.607044952392563,2.516870170593265,holidaymaker,3,14,17
3.9617453536987384,2.11076868438721,homeowner,26,74,100
3.260661941528319,2.4155099258422865,homosexual,727,287,1014
3.1296812896728525,2.457417663574219,honey,1016,3,1019
3.1065502319335963,2.89056131744384,hopeful,260,26,286
3.6683689422607486,2.6702302246093694,horticulturist,23,10,33
4.238665908813466,1.872152168273928,host,4855,2168,7023
4.3525609283447295,2.6188966369628943,householder,118,43,161
3.045919937133789,1.0787358322143632,hugger,10,3,13
3.5471181945800794,2.581926750183115,hulk,695,25,720
3.2316540603637876,2.554267494201653,humanist,232,24,256
3.444963821411143,2.4871854248046787,humanitarian,705,6,711
3.5535860214233495,2.733175086975102,humorist,48,13,61
3.704787292480461,2.134555442810054,humpback,115,33,148
3.8839551315307617,3.032209617614747,hunter,2405,1345,3750
4.3354766235351505,2.8640058364868253,husbandman,24,12,36
3.4040199432373015,1.9616427154541185,hybrid,1404,491,1895
3.5156032714843803,2.5745905151367197,idealist,44,23,67
3.8205121307373062,2.6794159851074113,ideologue,38,15,53
3.511081871032708,2.3230843048095906,idiot,257,75,332
3.39779524230957,2.4555038757324326,idler,24,11,35
3.425930717468269,1.886665092468263,illusionist,29,4,33
4.163067985534667,2.3985533218383637,imam,168,35,203
3.7817734832763747,2.8642060699462917,imitator,19,68,87
3.6156858062744064,2.041780357360828,incarnation,560,200,760
3.053233222961424,2.899657882690434,incompetent,247,7,254
3.2311395721435474,2.563056465148904,independent,9332,204,9536
3.988455039978028,2.6599458389282233,individual,9095,5814,14909
3.1346049575805637,2.46347213745117,individualist,68,4,72
3.286548782348625,2.3057888336181662,inferior,883,10,893
3.581639579772947,2.4853232803344554,infidel,39,28,67
3.9588423385620075,2.5811796798706013,informant,197,95,292
3.9673033218383793,2.946160835266113,inhabitant,80,2425,2505
2.9547011642455985,0.5474156723022361,initiate,520,183,703
4.047332885742179,2.3393590316772475,initiator,70,38,108
3.978905326843261,2.575498512268055,instigator,68,30,98
3.6240219039916823,2.3135437011718736,insurgent,136,505,641
3.169107528686517,2.6954033966064443,intellectual,1618,375,1993
3.7829507827758846,2.629156768798822,interloper,11,7,18
3.6081517944335815,2.493802223205577,internationalist,102,10,112
4.325369682312001,2.6776517257690458,interpreter,309,104,413
3.1012901153564485,1.9756051483154309,intimate,942,26,968
4.179379058837874,2.665248138427735,intruder,170,146,316
3.7155701599121045,2.852148544311518,inventor,450,97,547
4.443823493957524,2.7685567321777285,investigator,315,689,1004
3.846414604187018,2.7006658554077205,investor,282,966,1248
2.7157302932739285,2.6750567779541115,irregular,954,99,1053
3.8834211883544896,2.7518805694580024,islander,205,587,792
3.427947746276871,2.3742547988891545,isolationist,54,7,61
3.3159043197631775,2.27178971099854,jock,184,16,200
4.257946228027336,2.3547237396240206,judge,4872,1916,6788
3.779545852661137,2.090730819702145,jumper,233,105,338
3.446081924438481,2.3690412597656234,junior,4573,210,4783
4.228908210754383,2.199318778991696,jurist,112,80,192
3.0388966598510763,2.3797119293212887,juvenile,1216,771,1987
4.231239631652834,2.535275871276852,khan,2611,21,2632
3.902036666870117,2.6850075073242152,kid,1678,2277,3955
4.090622482299793,2.4363377075195274,kidnapper,51,73,124
3.6114577560424905,2.6043470840454077,killer,2162,363,2525
4.09496765899658,1.9915319519043067,kinsman,132,86,218
3.728866950988781,2.4328108749389656,knocker,19,6,25
3.9213783035278453,2.601689880371083,lad,452,79,531
3.2744467239379915,2.078358634948721,lamb,1003,205,1208
4.260131355285658,2.4075123519897517,lawgiver,12,9,21
4.177953964233396,1.9878432922363345,lawmaker,21,116,137
3.833734115600585,2.6656619338989316,layman,67,100,167
3.738298294067377,2.5933222274780263,layperson,11,16,27
3.524443572998038,2.747720130920399,leader,10593,6269,16862
3.652668670654286,2.866285057067884,learner,34,55,89
3.3294524841308473,2.2622043762207085,leech,216,48,264
2.837226524353042,2.2646096496581976,lefty,76,18,94
3.5393805160522405,2.194485343933117,lesbian,1155,315,1470
3.2657435073852525,2.7203881683349636,liberal,3578,829,4407
3.2603462677001858,2.5557143783569387,libertarian,345,44,389
3.2836962509155327,2.3477912063598723,libertine,40,25,65
3.9757984085082967,3.4272085647583026,linguist,135,122,257
3.2483039855956974,2.3221486663818354,lion,2318,1555,3873
4.095300048828129,2.2542365036010708,liquidator,14,3,17
3.634281501770026,2.5793133010864366,listener,493,910,1403
4.430815711975107,2.6882672195434623,litigant,8,34,42
3.4675235824584973,2.786102455139158,logician,9,8,17
3.6458835144042823,2.352278366088882,logistician,3,4,7
3.4059380722045987,2.7814623565673813,loner,89,9,98
3.745817031860355,2.2698080139160055,looker,7,4,11
3.9411030807495138,2.5322116622924966,lord,9878,2043,11921
3.765133453369131,2.338654632568357,loser,332,101,433
3.5860372543334975,1.7077936248779366,lot,6579,982,7561
4.182998664855951,2.5923028945922937,lout,5,4,9
3.6461759033203123,2.6425573959350643,lover,1724,878,2602
3.2446692581176677,2.616912673950182,lunatic,154,37,191
4.0308289566040045,2.6116680831909207,machine,7173,1647,8820
3.530353157043457,2.47110108184814,magician,286,100,386
3.2683402023315438,2.950534133911134,mailer,32,4,36
3.4131440963745163,3.0885892486572217,maker,998,646,1644
3.6658213882446233,2.62368238830566,male,9170,4774,13944
3.9314719161987384,2.924597801208492,man,30762,32879,63641
3.843074584960938,2.4292139892578035,manipulator,53,15,68
3.882967613220231,2.681335510253902,marcher,83,105,188
3.87693105316162,2.414581497192394,mascot,689,140,829
3.067385253906245,2.1675981140136713,master,6147,1962,8109
4.150559692382821,2.2114129409790024,mastermind,125,23,148
3.3481826934814407,2.1334911499023335,matador,71,9,80
3.5911912155151384,2.9068535690307726,mate,1933,788,2721
3.3299628295898316,2.3597003021240397,materialist,37,3,40
3.628617515563967,2.804305686950684,mathematician,445,244,689
3.698269485473631,2.0191046295165975,mentor,879,86,965
3.0624384307861305,3.0723366622924715,mercenary,329,507,836
4.051381248474129,2.543675910949709,messenger,644,245,889
3.754029228210456,3.509512100219723,metallurgist,17,22,39
3.632378746032714,3.0839219818115424,microorganism,17,150,167
3.0940916366577156,2.8034786605834867,midget,221,25,246
3.2275786895751963,2.8490093460083017,migrant,271,387,658
3.283555953979487,2.530020568847654,militarist,16,11,27
2.896279426574708,2.586590744018551,millenarian,20,3,23
3.766427970886241,2.4775457458496106,millionaire,439,101,540
3.8346027984619155,2.270368270874016,mineralogist,26,3,29
3.025692131042483,2.866520431518545,minor,9647,325,9972
3.333540336608884,2.2714305725097574,misfit,45,68,113
3.4882963714599597,2.693904075622548,missionary,872,796,1668
3.6141263504028274,2.208875358581544,model,8931,4412,13343
4.062452117919932,2.559016685485844,modeler,7,14,21
3.064831420898429,2.399637733459471,moderationist,3,7,10
3.631229995727523,2.101795135498051,modifier,12,23,35
4.0315266113281325,1.5784038314819355,mogul,81,44,125
3.479510238647457,2.795273284912099,moneymaker,14,4,18
2.894223686218254,2.5296380920410115,monolingual,23,3,26
3.696196998596193,2.9736849136352674,monster,2710,1545,4255
3.529742347717267,2.294788108825685,moron,20,10,30
3.5845538177490255,2.7205559005737285,mortal,1050,66,1116
4.1757446899414035,2.726004608154291,motorcyclist,24,20,44
3.7065255889892583,2.279583038330067,mountaineer,132,278,410
3.8208042449951165,2.114877342224112,mourner,29,268,297
3.7046507949828964,2.0023757553100623,mouse,1447,563,2010
3.700999336242674,1.5929709396362313,mover,97,45,142
4.03543702697754,2.60202986907958,murderer,536,180,716
4.181818122863774,2.126749931335439,musher,18,66,84
3.197230400085445,2.7310383682251,mutant,417,209,626
3.4196043701171916,0.4685829010009712,mute,191,17,208
3.4458262863159206,2.4105031356811537,namesake,443,19,462
2.9579118576049694,2.650208610534662,national,45586,624,46210
3.1112464141845706,3.3360825958251965,nationalist,1439,581,2020
3.055764503478997,3.3887842636108374,native,8244,910,9154
2.9156159515380864,1.6867262115478496,natural,10166,82,10248
2.9809511489868186,1.4381419067382808,naturist,4,3,7
3.8226992034912115,2.729655693054198,navigator,307,77,384
3.4969526748657245,1.8672666931152264,nazi,2747,791,3538
4.255170661926265,2.045646080017093,negotiator,111,89,200
3.698641525268556,2.4667896347045826,neighbor,651,678,1329
3.6734212265014676,2.458746360778811,neighbour,306,980,1286
3.395791107177736,2.795657943725587,nerd,79,51,130
3.3417395248413087,3.036602592468256,nestling,69,203,272
4.202264320373544,2.265430381774891,newsman,16,6,22
3.5249038009643527,2.026457870483391,nigga,33,48,81
3.526485267639174,2.161671684265137,nihilist,16,7,23
3.915851623535154,2.918275657653801,nobody,1284,26,1310
3.5108227615356498,2.8555654449462793,nonconformist,69,24,93
3.092539314270013,2.737622398376459,novice,133,38,171
2.7809552764892516,2.6978153533935654,nudist,11,3,14
3.975837005615233,3.1942637100219713,numismatist,103,48,151
4.4645725555419915,2.3121559753417955,oaf,8,3,11
3.6014102630615312,2.925627731323246,objector,28,44,72
3.6827359237670834,2.8954409255981446,observer,1706,1213,2919
3.18939031982422,1.3305751647949222,occult,282,4,286
3.332215065002437,2.6901014556884917,occultist,64,28,92
3.9890751495361414,2.6750427474975638,occupant,124,439,563
3.8274667739868136,2.5329527511596766,occupier,57,94,151
3.970437026977514,3.6056848602294878,oceanographer,26,7,33
2.868785736083993,3.0264976196288984,oddball,39,4,43
4.040362060546876,2.7723292160034205,offender,149,200,349
3.0266736373901253,2.1261378021240205,official,14224,7271,21495
3.1504836349487277,2.5698503723144626,offspring,959,8,967
3.6683087463378854,1.7430434341430612,oiler,77,513,590
3.749418945312506,2.3289722518920826,opener,915,145,1060
3.8169376296997015,2.703688980102534,operator,1272,950,2222
4.163840774536126,2.6219687118530217,opponent,2661,3149,5810
3.2302931442260743,2.6507561798095693,opposite,3650,104,3754
3.253523735046379,1.8454891204833928,opposition,5996,33,6029
4.193905738830573,3.068159378051753,organism,612,1676,2288
3.3594237365722535,2.334916694641109,originator,73,32,105
3.7529204788207906,2.0256900405883798,orphan,293,228,521
3.1195394973754844,3.1614407730102556,ostrich,104,34,138
3.5224553451538156,2.6019023590087826,outcast,132,115,247
3.8325013809204194,2.9677034988403364,outdoorsman,13,4,17
3.5785365295410045,2.8273492813110224,outsider,288,219,507
3.810645744323729,2.4379606552124073,overlord,411,94,505
3.761217552185066,2.399948875427249,owner,4043,3208,7251
3.4164203872680687,2.270993865966801,pacifist,131,31,162
3.022373764038079,2.437881614685068,pagan,1001,113,1114
3.6863735504150412,2.1667222900390612,pal,393,79,472
4.0282115707397494,3.2986955032348533,palaeontologist,89,45,134
4.135236709594736,2.844592056274408,paleontologist,237,212,449
3.5070237350463813,1.5524763870239298,pansy,16,4,20
3.9858115081787275,2.6226171264648457,parachutist,10,35,45
3.5609875640869078,2.219976913452143,paraplegic,61,5,66
3.645407562255855,2.281704086303712,parasite,480,689,1169
3.565560905456543,2.6419654006958027,parent,1965,7259,9224
3.134089057922367,2.963299209594723,pariah,37,4,41
3.971056442260746,2.211191436767585,parliamentarian,225,228,453
3.5097867507934595,2.579936134338375,parrot,485,274,759
3.7185220794677747,2.9031084671020437,participant,503,1763,2266
3.2507154312133792,2.76716087341309,partisan,1034,924,1958
3.566742111206054,2.9292996520996084,partner,3356,1725,5081
3.84478611755371,3.0309588317871103,party,26195,4288,30483
3.731210617065436,2.7921681213378946,pasha,580,8,588
3.1560616531372077,2.5052604141235335,passenger,3612,3795,7407
3.5637898483276444,1.7490078201293926,passer,272,66,338
3.2243876724243137,3.109795127868651,pathfinder,69,45,114
3.587025367736821,2.663360435485828,patient,1587,2039,3626
3.3443911209106503,2.8310330734252958,patrician,91,102,193
3.847228515624998,2.888610717773439,patriot,574,635,1209
3.978361137390138,2.325115554809571,payer,32,28,60
2.990227035522466,2.043478393554693,pedestrian,581,236,817
3.444750045776374,2.2935481719970596,peer,556,986,1542
3.6443027191162116,2.71725131988525,perfectionist,145,9,154
3.58683539581299,2.668756752014154,performer,1139,1440,2579
4.004836944580077,2.4324623641967804,person,11675,49224,60899
4.152724578857423,2.27603639984131,personage,31,38,69
3.4789496154785127,1.7281022796630836,personification,141,32,173
3.428579010009763,2.6070779418945307,pet,980,387,1367
4.120940383911133,2.3255793151855357,petitioner,56,66,122
3.369296630859367,2.6894620285034208,philistine,31,30,61
3.594984428405759,2.4124669570922848,philosopher,1071,527,1598
3.6867148056030317,2.6425050582885774,physicist,630,364,994
3.1908367767334056,2.078677703857423,picker,36,35,71
3.6075210113525387,2.4287320632934524,pitcher,1788,547,2335
4.032981277465829,2.771966796874999,planet,6078,2394,8472
3.6798185195922954,2.7264060211181587,planner,153,377,530
3.4555991058349633,2.266810897827149,plant,7415,5599,13014
3.689244171142583,2.249837455749528,planter,112,105,217
3.407720062255862,2.5075635452270575,plantsman,4,7,11
4.223108596801751,3.2011004257202273,player,27922,20973,48895
3.2186995162963967,2.0892309646606435,pleaser,25,3,28
3.307359611511231,2.251996849060056,plebeian,172,114,286
3.6147585449218695,2.9737776260376023,plotter,27,166,193
3.9769904403686525,2.4116953887939516,poisoner,18,7,25
3.9173281860351565,2.225710006713875,politician,1622,1734,3356
3.5188357467651343,2.7072200088500864,polymorph,13,7,20
3.081528205871578,2.38703468322754,polyploid,10,7,17
3.346428421020505,1.9402487564086925,populist,280,44,324
3.11456858825683,3.6572264785766606,positivist,36,15,51
4.104478370666506,2.583205680847172,possessor,44,12,56
3.7130887908935577,0.9921264114380008,poster,893,675,1568
3.9678158874511738,2.4997415771484413,potentate,5,13,18
3.444262908935542,2.511937400817871,powerhouse,224,22,246
3.5130608291625833,2.699051734924325,pragmatist,16,11,27
3.4285920944213757,0.9313295135498052,prayer,1689,515,2204
3.558178939819342,2.212348945617677,precursor,807,238,1045
3.8411282958984643,2.8403479919433465,predecessor,2358,1121,3479
4.0133618774413975,2.226161582946773,presenter,374,82,456
3.493453125000002,1.925667335510255,preserver,23,8,31
3.37128433227538,1.9072664718627976,preteen,22,4,26
2.7518855361938463,2.578051269531244,primitive,1094,31,1125
3.6985813064575197,2.217464103698731,prisoner,2082,4335,6417
3.7106442718505903,2.298416099548348,processor,369,188,557
3.5816582260131966,2.7755085525512726,producer,10663,5972,16635
3.117544494628909,2.878129653930664,professional,9659,775,10434
3.797910636901854,2.264572509765628,profiteer,4,8,12
3.7983110885620235,2.624668815612793,programmer,376,275,651
3.039921798706054,2.7629319610595644,progressive,1974,66,2040
3.645101387023928,3.3921280136108294,prokaryote,8,103,111
3.741659164428718,2.6095955352783164,propagandist,62,27,89
3.4782714080810706,2.5063448944091817,propagator,4,8,12
3.6130525283813526,2.2424852142333975,prophet,560,211,771
3.7511250076293834,2.7077199630737283,proponent,358,467,825
3.4517527847290026,1.8168070526123046,prospect,1495,695,2190
4.301800033569336,3.418900268554694,protagonist,2821,726,3547
3.1333581924438505,1.6382846374511644,protectionist,83,16,99
3.4067212524414003,2.181478233337401,protector,494,89,583
3.4165993194580153,2.9359465484619065,protester,79,834,913
3.6975446853637735,1.8916761093139627,psychic,426,13,439
3.6445354461669837,2.1929821014404496,publicist,216,26,242
3.7775396957397405,2.5212120819091837,pugilist,10,9,19
3.9486512603759536,2.3756435241699307,puller,70,5,75
3.8459199523925776,2.4151939163208027,punter,140,15,155
3.446748184204104,2.749159210205086,pupil,643,1177,1820
3.45811357116699,2.6975588302612294,puppet,757,391,1148
4.023880668640139,3.0675343856811494,pursuer,34,129,163
3.5555209350585883,2.5963840713501014,pussycat,98,10,108
3.6717952880859386,2.5947790451049713,pygmy,309,12,321
3.7247454528808603,2.377236122131343,qualifier,295,178,473
3.807943458557105,2.3432537155151465,quarryman,7,121,128
3.9894372863769547,2.0021368179321186,queen,11098,1166,12264
3.3939257888794003,2.388016960144043,radical,2099,337,2436
2.732609405517586,1.8868747711181726,rafter,39,110,149
3.477480636596681,1.8539977951049949,ram,1117,524,1641
3.5189179763793845,2.509475891113297,rambler,46,31,77
3.6160543060302714,2.3358192672729388,rat,917,913,1830
3.6464026107788072,3.0251241073608384,rationalist,56,5,61
3.66816893005371,2.625846054077158,raver,26,3,29
4.121332984924315,2.8049080352783378,reader,1645,2530,4175
3.1991724624633733,2.991967109680182,realist,175,20,195
3.7727340316772526,2.379728134155286,receiver,1075,346,1421
4.255855232238758,2.5493716659545953,recipient,942,539,1481
2.8387910232543874,1.8844814682006756,recombinant,53,3,56
3.5540909500122098,1.754507553100595,rectifier,19,24,43
3.073669822692864,2.4786620101928776,recusant,19,29,48
3.043466674804691,1.584266281127924,referral,69,12,81
3.973589241027824,2.6883457794189525,reformer,262,373,635
3.116859741210938,2.4763129043579255,reformist,152,26,178
4.400541503906247,2.219903541564932,regent,858,329,1187
4.050659019470217,2.649703102111829,registrant,22,13,35
2.9666476516723606,2.6284870758056655,regular,10127,541,10668
3.0444339675903294,2.2624222869873094,relative,3500,1927,5427
3.012252784729,2.772737083435061,relict,45,6,51
3.962186088562021,2.3784204788208,reliever,130,38,168
3.4626930465698322,2.717839202880853,renegade,168,60,228
3.2353090286254798,2.2128037567138676,repeater,23,24,47
3.5831577453613264,2.1081953659057717,replacement,3695,469,4164
3.930103729248053,2.908235473632814,reporter,2158,960,3118
3.5530524597167883,2.4112769012451167,representative,3604,3665,7269
3.258121696472166,2.6558498077392585,republican,5703,1900,7603
4.025433609008793,2.779698768615738,rescuer,35,129,164
3.7317388381958025,3.190992980957027,researcher,573,2025,2598
3.4945156631469914,2.670562644958487,resident,2894,6817,9711
3.4390213165283257,2.6823435363769406,resister,7,31,38
3.9411585083007807,2.8283543624877936,respondent,74,285,359
3.6347007141113323,2.83729394531251,responder,19,53,72
3.6971188278198284,2.4868725051879963,retainer,72,113,185
2.813283302307127,-1.6331783370971777,retard,29,9,38
3.7254086151122863,2.694311447143548,retiree,6,30,36
3.585813179016114,2.258763824462889,revenant,77,17,94
3.135968498229971,2.523143760681151,revolutionary,3007,415,3422
3.790115112304683,2.597734085083019,revolutionist,13,9,22
3.6879390563964876,2.9529504776000977,rider,1748,2746,4494
3.738378410339351,2.6476019058227607,ringer,61,34,95
3.4101262893676676,2.2907658843994056,riser,34,15,49
3.4489360198974595,2.4571261062622085,rival,3393,1796,5189
2.7784240341186432,2.4322468338012655,rock,20733,2453,23186
3.592205490112299,2.366768753051751,romanticist,20,4,24
3.6431932983398383,2.2616253814697416,roommate,220,69,289
4.201796424865719,2.309942352294925,rounder,239,35,274
3.9357658996582074,2.2919110260009887,rover,243,1019,1262
4.151957885742199,2.1797947921752936,ruler,2020,1278,3298
2.99705796813965,2.3847337875366392,runaway,369,62,431
3.545467170715334,2.6925906906127963,runner,1782,1214,2996
3.355534065246573,1.5250698089599624,runt,25,3,28
3.760595817565928,3.170198944091794,rusher,124,44,168
3.605352066040041,1.684373222351084,sacrificer,4,3,7
4.415337432861328,2.006839256286611,saint,7507,1553,9060
3.8139377288818395,2.9568450088501166,salvager,4,6,10
3.889375511169419,2.9460240097045727,salvor,4,7,11
3.484238296508785,2.560575752258302,samurai,255,4,259
3.413050369262699,2.4934213104248215,satellite,2778,536,3314
3.255801078796395,2.468293525695799,savage,1243,89,1332
2.927660545349127,2.469407623291005,saver,22,14,36
3.832963989257813,2.5658946914672853,savior,197,18,215
3.2504038696289115,2.414804840087882,scab,14,15,29
3.519722984313958,2.0176798858642613,scalawag,4,10,14
3.6573031234741222,2.92486265563965,schemer,14,4,18
3.9872054519653233,3.197143875122073,scholar,2260,3394,5654
3.7269250564575174,2.502973777770997,schoolfriend,14,4,18
3.4072476882934666,2.3563237762451195,schoolmate,43,54,97
3.852444221496576,3.0423075027465813,scientist,1552,3121,4673
3.8287713546752897,2.543717857360839,scorpion,175,121,296
4.003989326477054,2.2825054321289002,scoundrel,25,35,60
3.3636128997802786,-0.07838314819335324,scourge,62,5,67
3.2527589416503915,2.411015121459968,scout,1937,1222,3159
3.574646354675302,2.449089744567864,screamer,6,13,19
3.2142841110229483,2.0125292053222665,scrubber,7,7,14
3.4160202407836877,2.7189166488647345,searcher,25,49,74
3.0380588760375957,2.7251289978027273,secessionist,90,29,119
2.9681041259765593,2.6353824768066474,secular,1092,3,1095
3.5181816711425853,2.977110527038576,secularist,9,7,16
3.7779264678955116,2.5452521438598694,seeker,96,196,292
3.2760241012573275,2.522967720031744,seer,72,13,85
3.8794590682983454,2.507561424255371,selector,111,417,528
3.6099078598022345,1.6937649002075261,self,10629,83,10712
4.165023567199711,2.45903981018067,sender,40,11,51
3.2923032150268554,2.34106223297119,senior,6947,291,7238
3.3445186004638643,2.7547031402587976,separatist,154,73,227
3.705532768249519,2.2359450302123847,servant,932,1108,2040
3.680812721252444,1.9845305328369136,shaker,89,36,125
3.851505783081052,2.58626738739013,shark,3428,2071,5499
3.9909858551025366,2.1169546585082912,sheik,80,16,96
4.004332489013677,1.8145195922851514,sheikh,311,55,366
4.0973262481689545,2.5196829223632733,shipowner,12,17,29
3.2863927230834946,3.1368699035644525,shooter,949,311,1260
4.065771423339839,2.35218667602539,showman,80,12,92
3.4530908279418924,1.9005552215576174,shrimp,352,67,419
3.6231100463867136,2.967020683288574,sibling,242,1035,1277
3.6854600372314437,2.6168835601806677,sidekick,199,33,232
3.746298255920415,2.8551622390746942,signaller,15,43,58
4.000907608032236,2.420637573242189,signatory,107,183,290
3.9171736602783227,2.38396101379395,signer,38,121,159
3.426479896545416,2.8389446105956893,sissy,18,3,21
4.236381202697757,2.4703893356323263,sitter,144,33,177
3.761115524291988,2.735732238769529,skeptic,108,102,210
3.120278282165529,2.8190077438354493,slave,2202,2469,4671
3.0319576644897452,2.0237911300659164,sleeper,244,101,345
3.7593750915527266,1.688839805603024,slider,124,28,152
3.8172586898803615,2.7239536972045926,slinger,8,12,20
3.6386374130249024,2.2869982070922887,smith,11915,209,12124
3.4994830169677726,1.8574009857177742,snake,1742,725,2467
4.027532371520991,1.9249370498657186,snatcher,22,40,62
3.8346105728149382,2.7934584045410276,snowboarder,20,10,30
4.0616954421997065,1.976877120971679,sorcerer,270,50,320
3.4670222091674816,2.5833914337158177,source,8045,6796,14841
3.443759292602543,1.832005020141601,southpaw,21,3,24
3.8630419998169003,2.116554168701171,sovereign,1265,128,1393
3.8196204147338833,3.0055154266357462,spaceman,67,7,74
3.316827400207522,1.2890765762329153,spade,86,65,151
3.493326828002928,2.4634819717407197,spearhead,131,42,173
3.2704324264526434,2.83811402130128,specialist,1207,385,1592
3.503330360412612,2.0829337005615116,specifier,3,5,8
3.9362269821166933,2.243134475708011,spectator,442,1348,1790
3.5737779083251837,2.6235415496826135,speculator,54,105,159
3.4034862289428602,1.6109466018676741,sphinx,61,8,69
3.296904418945317,1.8527322387695335,splitter,45,13,58
3.447382415771493,1.7677775268554683,spoiler,78,67,145
3.9241136627197193,2.6134811019897484,spokesperson,608,19,627
3.2029409179687462,2.4488583145141547,sponge,263,274,537
3.8074773406982416,2.020771736145022,sponsor,723,507,1230
3.4124935913085963,1.9088461074829226,sport,3920,7486,11406
3.236061141967781,2.9871246948242174,spotter,78,53,131
3.334578582763669,1.606938659667975,spouse,154,127,281
3.7843302536010697,2.6424467926025557,stakeholder,14,78,92
3.132060836791986,2.9227643737792945,star,22042,11432,33474
3.6868120956420896,2.137261566162117,starter,928,237,1165
3.8838061676025433,2.6000569763183563,steward,350,201,551
3.8500300674438392,2.652638328552257,stooge,15,110,125
4.204196121215816,2.5889764099121066,stranger,707,303,1010
3.8644710693359343,2.6447844848632798,strategist,116,46,162
3.5443054046630778,2.267795524597176,strikebreaker,3,27,30
4.160317192077642,2.9354407196045003,striker,1037,273,1310
3.704133407592778,2.0416082153320474,stringer,86,22,108
3.8022775955200245,1.9303132324218808,stripper,146,102,248
3.316463455200214,2.787938827514651,student,7009,11675,18684
4.004241889953619,2.6540890350341613,subject,8316,2649,10965
3.3451579971313308,1.4623809967040984,substitute,1824,209,2033
3.2666742401123017,2.413688972473139,subversive,235,16,251
3.881609687805188,2.5668713378906247,successor,3119,590,3709
3.460941268920905,1.9399278030395521,sucker,150,71,221
3.5559290008544906,2.2561082000732426,sufferer,47,77,124
3.7806114730834963,2.6557158966064236,suffragist,43,45,88
4.088941680908199,1.9995596313476653,sultan,1768,71,1839
3.564457473754885,2.591147399902354,superior,3078,408,3486
3.510572845458981,2.4147508239746003,superman,1174,18,1192
2.902281784057621,2.346834526061997,supernumerary,38,8,46
3.777327209472652,2.800463508605951,superstar,488,287,775
3.486842964172368,2.6108234939575254,supplicant,7,7,14
3.6147242965698254,2.3235956497192305,supporter,1286,4151,5437
3.460519660949714,2.548130699157724,suppressor,39,11,50
3.006789337158196,3.0915086517333776,supremacist,57,19,76
3.6572698287963874,2.1081433639526423,surveyor,413,111,524
3.3763258361816426,3.0572915039062494,survivalist,5,4,9
3.68198344421387,3.0062400436401546,survivor,1246,2755,4001
3.860653717041018,2.1903643951416,suspect,1121,795,1916
3.094426033020028,1.4366962203979483,sweater,156,45,201
3.66274118804931,2.122125061035149,sweetheart,241,36,277
3.909054809570314,2.500240242004402,swimmer,508,319,827
3.7061747131347644,2.7091605606079128,swordsman,71,20,91
3.7464935913085924,2.3982837677001925,sympathizer,60,168,228
3.0794627304077125,2.6812333831787214,syndicalist,55,22,77
3.781955284118645,3.176212913513183,tactician,53,17,70
4.230119483947753,2.0606386337280327,tapper,29,4,33
3.0017382888793946,-2.3350631332397427,tease,115,55,170
3.090453292846682,1.0455177536010751,teaser,488,43,531
3.7370956192016607,3.162909919738773,technician,275,319,594
3.650164947509765,2.5625948638916043,technocrat,5,8,13
4.087909530639649,2.1646829223632835,technologist,12,8,20
3.1503325271606286,2.845555587768544,teen,1277,435,1712
4.049365356445307,2.724514991760252,teenager,893,666,1559
3.436316551208492,2.362801033020027,teetotaler,24,4,28
3.1679749908447263,0.9167727737426645,terror,1019,48,1067
3.4794496231079037,2.337321464538576,terrorist,911,385,1296
3.579085151672359,2.9878626251220624,theoretician,27,8,35
3.487536354064943,3.4344417572021513,theorist,250,270,520
4.110660942077644,1.8225905685424877,therapist,159,61,220
3.686587570190426,2.099633102417002,thinker,129,202,331
3.42706563568116,3.144109970092785,thoroughbred,319,119,438
3.4945759124755824,2.6198479232787975,thrower,72,163,235
3.9030459823608368,2.3440006713867163,tiger,1842,1700,3542
2.9616579208373963,1.2979848175048758,tinker,300,11,311
3.1632143402099615,2.0579012145996103,tool,1291,1731,3022
3.831981330871571,1.6329777221679649,topper,138,24,162
4.261203224182125,2.4275958480834987,torchbearer,9,6,15
3.0808184280395494,2.6166321029663067,tourist,1593,1453,3046
3.6223018646240277,2.6805054397582992,townsman,3,26,29
4.170867568969726,2.4398799057006855,trainer,694,326,1020
3.44741989135742,1.8390294189453158,transfer,4003,437,4440
3.9336965942382918,3.211820770263685,translator,340,110,450
3.4757148895263725,1.9810975646972508,transmitter,237,115,352
3.2918709259033108,1.6453912429809492,transsexual,67,12,79
3.4509557800292967,2.087088729858408,transvestite,33,14,47
3.7755991439819354,2.6695827713012648,traveler,264,565,829
3.9922907257080027,2.6595924224853533,traveller,338,296,634
4.0830628967285065,1.5266405410766595,treasurer,664,19,683
3.616605987548837,2.4343685989379793,trespasser,14,35,49
3.3815242004394577,2.3639293746948127,trimmer,191,23,214
3.5992446060180683,2.541220581054688,troublemaker,49,21,70
4.019284706115727,2.4359814910888673,trustee,438,1088,1526
3.552761253356934,2.542582130432123,turncoat,14,5,19
4.041940811157225,1.8035998153686421,turner,2043,10,2053
3.110345123291019,3.1886073455810546,twin,3171,1065,4236
3.615714759826652,2.4219920501709,tyrant,321,108,429
3.681401443481434,2.9522445144653275,unbeliever,11,27,38
3.381219085693374,2.7399520034790044,unionist,175,134,309
3.673762763977038,2.9720309295654346,user,1624,2111,3735
3.893879234313971,2.6084141769409115,vacationer,3,18,21
3.7903525314331077,1.89816571044922,vassal,359,179,538
3.4794014205932626,2.26683512878418,veteran,1797,1772,3569
3.9872561645507787,2.393837730407718,victim,1791,3195,4986
4.156378868103033,2.5950871200561423,victor,2341,166,2507
3.6588007888793967,3.330446266174306,viewer,1001,7379,8380
3.9939828414917073,2.7524524307250857,villager,61,671,732
3.9682959899902386,2.710129020690921,villain,1466,866,2332
3.617414619445796,1.932837158203128,virgin,2202,77,2279
3.1654066467285205,2.6701353607177722,virtuoso,179,9,188
3.362658454895012,2.989132034301761,visionary,215,11,226
3.6437775115966815,2.6137652969360445,visitor,1018,3227,4245
3.1397108459472634,2.80158131408691,volunteer,1614,2063,3677
3.789309410095214,2.8206905136108418,voyager,815,13,828
3.9702871398925765,1.5926089172363334,waiter,176,51,227
3.746829650878894,2.5281203079223644,walker,2773,235,3008
4.071419258117672,2.572448921203616,wanderer,101,815,916
3.4166989517211874,2.368361579895023,wannabe,103,16,119
3.3801122817993274,2.5032655944824285,warhorse,7,8,15
3.0205788803100546,3.211211990356432,warmonger,7,3,10
3.523619026184086,2.620826820373537,warrior,1570,1986,3556
2.932147048950185,1.4632918319702242,washer,32,10,42
3.6472817153930706,2.623419570922856,wasp,566,371,937
3.791179916381836,2.2916768722534187,watcher,67,93,160
4.065137237548825,2.2716051025390698,waterman,75,7,82
2.9643880386352492,-0.6003796539306663,waver,40,10,50
3.854814224243164,2.4981906204223634,wearer,94,16,110
3.622962829589845,2.7586656265258895,weasel,198,78,276
3.974156288146972,3.336387046813961,westerner,27,114,141
3.7563316268920914,2.6187603225708003,whale,1677,1475,3152
3.0654090118408277,2.5337957534789908,whiz,34,3,37
3.705299285888671,2.772390907287601,wimp,9,4,13
3.9223252716064536,2.098022232055669,winner,4292,1990,6282
3.494269790649419,0.8182432250976603,wiper,3,17,20
3.611969535827633,2.16466962432861,wisp,19,13,32
4.0375119552612375,2.367621879577648,witch,1227,594,1821
3.4725161895751953,2.05306556701661,witness,1586,1783,3369
4.049793258666988,2.5323314437866173,wizard,754,433,1187
3.8679247436523383,2.8273687438964785,woman,11305,21958,33263
3.541064117431638,2.8273452835083006,worker,1509,6464,7973
3.408590995788579,2.7813379516601415,workmate,4,4,8
3.834187866210925,2.749790977478021,worshiper,9,56,65
4.0099543838500935,2.268994110107421,worshipper,25,112,137
3.8977378692627056,2.4645809631347646,wrestler,969,1096,2065
3.576119705200192,3.099608757019041,writer,11195,8004,19199
4.273463768005371,2.3474644927978545,wrongdoer,8,5,13
3.8429716796875013,2.9575681533813523,youngster,110,118,228
3.3805252380371016,2.656428337097168,youth,5056,301,5357
3.7722688217163096,3.0616811294555646,zealot,22,28,50
3.1736124572753894,2.687408607482901,zombie,601,342,943
3.9898179016113176,2.7590451507568474,zooid,17,73,90
