s,p,sent,s_freq,p_freq,freq
2.8706790542602505,4.93708610534668,abductor,15,19,34
-0.36010361480711595,3.602848648071287,aboriginal,830,72,902
1.8734686660766613,4.132952049255358,aborigine,20,235,255
-1.2710409698486416,3.8791922302246107,absentee,111,6,117
-1.2129114303588864,1.586769012451171,abstainer,4,4,8
1.5977077713012662,3.7727754211425832,accumulator,26,24,50
3.8280842132568367,4.420121566772458,accuser,39,38,77
2.703250839233398,4.093473121643065,ace,1494,295,1789
2.9982454910278307,3.590422973632812,achiever,25,6,31
0.40757964324951956,3.291457275390627,acquaintance,373,218,591
0.6152576446533189,2.6730687789917056,actor,8770,6109,14879
0.8231198425292945,1.7805397186279137,actress,5705,614,6319
2.7015389099121094,4.6849601593017525,addict,145,72,217
0.23545269775390665,2.8822701644897464,adherent,66,352,418
2.6759194488525395,4.035772415161134,adjudicator,11,5,16
1.3450931625366138,2.862587829589849,administrator,782,492,1274
1.2031706848144452,3.9531806945800767,admirer,270,182,452
0.5615006256103428,4.5338897399902365,adolescent,335,209,544
0.14870565032958893,3.746388938903813,adult,5529,3574,9103
2.081636680603026,4.632911567687984,adventurer,192,152,344
3.571612281799304,4.410156829833987,adversary,196,197,393
0.2107072219848618,2.993433013916004,advocate,1365,653,2018
0.8244792251586901,2.806315826416018,agent,5241,3117,8358
1.3180060272216778,3.3801749496459905,aggregator,443,12,455
-1.3191686935424798,4.831774650573735,agnostic,128,33,161
2.4730731735229483,2.550969413757322,agonist,74,65,139
-1.614752220153811,3.0566841812133774,albino,85,11,96
0.18187329864502289,2.846085388183603,alchemist,112,43,155
0.17457016754150345,4.216608192443857,alien,3286,1309,4595
1.5258016433715866,2.3415561370849574,allocator,40,39,79
-1.4629185791015615,3.7530658950805744,amateur,2233,232,2465
0.3189739837646428,-0.8958144836425959,amir,541,4,545
-0.11710230255126675,4.542188690185554,amputee,59,28,87
1.301581214904786,3.9500402297973594,analyst,462,549,1011
-1.1504074172973588,3.63078657531738,anarchist,566,321,887
0.848781272888175,3.089935722351086,anatomist,72,47,119
1.6683031921386728,2.31007905578614,anatomy,1085,3,1088
0.013364662170410213,2.560861618041983,ancestor,931,1088,2019
-0.5318362197875999,2.440712493896484,ancient,6622,134,6756
0.7997395553588902,3.88696688079834,angel,2602,1354,3956
1.381452354431154,4.018786415100095,animal,5978,7775,13753
1.253241279602051,2.049473144531248,animator,391,736,1127
3.5237134628295905,4.234668212890625,announcer,324,99,423
2.8031185607910203,3.552428062438956,antagonist,884,345,1229
0.04587379455566065,2.0047162857055554,antiquarian,296,37,333
1.0611396713256909,2.570861076354994,antiquary,61,75,136
1.309815063476563,4.540076347351082,ape,207,372,579
0.4804244384765681,4.514793777465826,apologist,31,24,55
-0.19275641632080465,4.308525634765623,apostate,27,9,36
2.6379113693237315,4.167265335082995,applicant,269,385,654
1.6441399459838877,2.6860627288818293,appointee,73,147,220
0.05842681121826132,2.0377739410400366,appointment,2742,656,3398
2.688830848693847,3.6963391494750937,arbiter,248,22,270
2.196330795288084,3.5987373046874964,archer,950,324,1274
0.8804561843872065,1.7234381790161137,architect,2373,1256,3629
1.4963167343139645,3.2062276229858497,archivist,71,13,84
2.0785388641357443,3.4210300292968725,aristocrat,138,191,329
2.4278459930420055,2.636656257629376,artificer,12,7,19
0.9975789566040092,1.9239197311401313,artist,9094,7385,16479
-0.7879493408203118,3.9707776107788177,ascetic,142,50,192
1.0187618789672968,2.9279255142211866,aspirant,29,15,44
1.2314725646972775,3.883708953857422,assignee,10,5,15
-0.5008759307861297,3.5424409713745106,assistant,5266,498,5764
-0.7247038116454974,3.3234646530151366,associate,1675,1268,2943
-0.7467835006713912,3.72560375213623,asthmatic,33,5,38
2.5623058547973727,3.7626743469238306,astronaut,433,438,871
3.1595596084594675,3.81489035797118,athlete,1335,2410,3745
0.6596343154907345,2.6621883392333885,attraction,1582,735,2317
1.754683723449702,4.313654525756839,auditor,184,97,281
1.614035812377928,4.752861274719237,author,7640,3461,11101
0.814993156433097,3.4551782989501945,authority,7524,5340,12864
2.422079376220708,2.705226173400881,automaton,39,43,82
3.8534317245483436,3.1983968505859366,avatar,888,182,1070
1.7003896484375005,3.357009963989256,baby,4303,480,4783
2.0551138916015645,1.8457804260253923,balance,2775,122,2897
0.37123268890380956,2.55290938568114,banker,372,252,624
0.41250349426269395,4.478332244873052,barbarian,318,163,481
1.2244382553100621,2.895008636474614,bather,7,25,32
3.082443672180176,3.775178939819334,bearer,374,150,524
2.92030265045166,3.017802909851085,beast,1214,238,1452
2.6320726470947307,4.7184679489135775,beater,46,11,57
2.11613827514649,4.340641021728516,beginner,59,78,137
2.447163024902345,2.637885826110839,behemoth,83,3,86
2.5209916610717755,2.8873923416137757,beholder,54,3,57
0.712019729614255,3.3098128204345727,being,69128,978,70106
3.5858003005981445,4.0418311080932625,believer,355,228,583
-0.13455528259277827,4.002144035339356,belligerent,111,42,153
-1.173623527526857,2.1437847595214947,beloved,547,4,551
1.3304649429321245,3.7997681045532303,benefactor,187,94,281
2.7625957870483475,2.998796691894526,bidder,118,56,174
0.2766068572998037,3.471396942138668,billionaire,174,31,205
-0.07863490295411424,2.779898178100588,biologist,293,237,530
-1.3815075378417987,4.910142173767099,bisexual,298,9,307
3.354036712646476,3.5499262847900397,biter,12,4,16
-0.5384761657714847,3.415486953735339,bleacher,42,88,130
1.1179893951415991,3.6064053344726403,blogger,162,89,251
-0.7815196685791079,3.6871656036376947,blonde,641,31,672
1.6267339706420927,4.106093299865719,boater,9,57,66
3.020776664733887,3.993545089721678,boatman,23,25,48
1.6154516448974618,3.084385421752934,body,17987,5562,23549
2.5966682205200087,3.2852575912475572,bodybuilder,30,5,35
0.6405917510986328,3.409154777526851,bomber,2167,2884,5051
2.6919878463745093,3.6387007904052737,bondsman,3,5,8
-0.8307629852294909,3.064487823486317,boob,11,18,29
0.8370843276977524,4.862649810791019,bookmaker,37,73,110
-0.3364637145996099,4.450046279907227,boomer,66,27,93
0.626553367614747,4.3125316619873075,booster,281,98,379
1.6528880462646498,1.7976703414916955,boss,2156,471,2627
2.729887245178219,3.955587089538575,bowman,455,22,477
1.3818321914672964,3.1460854644775367,boxer,550,129,679
3.7505120391845708,3.973451194763186,boy,7855,4928,12783
1.713323089599612,4.336075027465824,boyfriend,1689,74,1763
1.5991796112060612,0.16851398468016754,brawler,28,5,33
0.16407888793945347,4.530352409362806,broadcaster,515,297,812
0.71639418792725,3.4525601577758778,brother,12442,6567,19009
-1.5159875183105456,3.456087081909182,brunette,74,5,79
-1.68552174377443,4.499638290405272,brute,186,45,231
-0.0797716751098605,4.1928476104736205,buddy,424,46,470
0.0035171890258780536,4.48058847045899,buff,458,42,500
0.8717098464965929,2.8556395950317253,builder,492,431,923
1.5516053771972693,3.423131172180163,bull,1696,585,2281
2.225401603698728,4.403752769470209,bullfighter,18,5,23
0.41303647613525385,4.462087875366215,bum,81,24,105
1.287486991882325,3.352806274414064,businessperson,16,37,53
0.598331665039062,2.8626299591064353,busker,7,3,10
2.259412887573241,3.0403000030517546,buster,238,265,503
3.220459152221679,3.537094390869143,caliph,564,52,616
2.8949121017456036,3.685077705383307,caller,146,39,185
2.501287994384768,3.450062133789075,candidate,4275,2755,7030
-0.817191390991205,3.749773384094226,capitalist,358,85,443
3.261156730651855,2.8077528305053647,captain,13626,805,14431
-0.25231645202637054,3.5566271438598633,captive,1064,352,1416
3.677494232177736,4.361198532104503,captor,36,210,246
3.0674281005859427,4.3746669921875,caregiver,173,125,298
0.734424980163574,3.9135128173828093,carrier,3591,2397,5988
3.008670280456535,2.1620408859252933,cashier,63,6,69
3.122134407043461,4.603539367675793,castaway,36,34,70
2.4751534805297837,2.6147540359497086,caster,29,9,38
0.4340234222412107,2.8749536819457973,catalyst,402,145,547
-0.16654235839843778,2.2156068038940333,category,6389,1759,8148
1.4241930007934585,3.6085335769653213,caveman,20,21,41
2.7520733413696377,3.5915951614379793,celebrant,13,3,16
1.1783229293823254,3.1318234481811587,censor,285,313,598
-1.3175169219970826,3.5489853973388676,centrist,68,7,75
3.135817207336437,2.842651748657225,centurion,169,43,212
2.619914237976076,3.89869017791748,challenger,456,153,609
2.0299038314819313,3.2376208038330176,chameleon,74,27,101
-1.5383108291625973,4.014550590515128,champion,5322,4183,9505
0.12482978057862226,3.4301445693969725,changer,48,22,70
3.2500794754028206,4.09152188110351,chap,46,23,69
2.080263908386229,2.872466011047372,character,34343,20753,55096
2.7591142654418945,2.442740928649897,charmer,33,6,39
2.4047990493774307,3.4323920745849534,cheerleader,180,94,274
0.6304074554443346,2.405402114868167,chemist,427,188,615
-0.20278555297851852,3.637671401977542,chicken,1204,264,1468
-1.5766027450561495,2.68050450134276,chief,12922,1421,14343
2.491428558349611,3.7446584854126,chieftain,219,180,399
2.77187291717528,2.5762315063476535,child,10686,22791,33477
1.8205271759033224,2.0119588546752993,choreographer,343,68,411
0.45308003997802615,4.285065490722658,chum,50,12,62
2.7022393875121935,4.061897132873526,churchgoer,12,20,32
0.3055933532714903,3.5540762939453217,citizen,1644,4207,5851
3.0531868362426664,3.325807304382323,claimant,322,157,479
-0.4918884963989285,3.3077957916259777,class,22588,3889,26477
1.242615386962882,3.8642226257324026,classmate,285,358,643
2.602568351745603,3.6418429031371957,client,849,738,1587
1.0648924942016578,3.8975053558349657,climatologist,5,11,16
2.098336944580076,3.0775481796264614,clone,530,430,960
0.45103553009032993,3.709241798400882,closer,3303,30,3333
0.6339589920043949,3.454678039550778,coder,5,8,13
-0.017979820251468936,2.7450939941406247,collector,1208,673,1881
1.793110694885243,4.1724840393066245,combatant,110,295,405
3.4002670211792037,4.453226699829102,comer,60,26,86
0.6205445098876936,2.250781982421884,commander,11359,1979,13338
1.979375656127921,4.19638263702393,commentator,705,1446,2151
1.8302598953247085,2.878567138671876,commoner,103,226,329
3.148954078674322,4.7003948059082035,communicator,55,23,78
-0.6183725738525396,4.385364952087414,companion,1945,908,2853
0.5951275939941354,4.903722061157225,compatriot,106,120,226
1.50080331420898,3.566247802734374,competition,8431,1677,10108
2.5113895187377935,3.7954942474365225,competitor,670,1164,1834
0.12074508666991335,4.4876774902343755,computer,6158,1189,7347
2.052116844177249,2.877685607910152,comrade,138,420,558
2.7496326522827133,4.303948738098143,confessor,201,12,213
1.4284909515380875,3.9146073226928664,confidant,112,27,139
0.7942767105102533,2.5238052520752063,congener,28,32,60
1.4573062591552741,3.825887519836428,conquistador,73,91,164
-1.204461105346681,2.660500869750976,conservative,3913,1056,4969
1.461330787658703,3.809814811706545,conservator,35,47,82
-0.5558789978027363,2.4513145217895485,consumer,1085,700,1785
-0.23111985015869152,3.2913107681274383,contemporary,7271,1034,8305
2.4222757339477567,0.9845342864990272,contender,690,440,1130
3.8967633972168088,3.834920692443852,contestant,600,631,1231
1.2014185485839803,3.0722193756103593,contractor,517,456,973
1.975384498596199,4.764031822204586,controller,1077,450,1527
-4.118522537231449,2.5796682434082143,coon,178,31,209
-1.2234633865356415,2.559903823852551,copycat,47,4,51
0.7104891052246103,3.7591837387084936,correspondent,740,161,901
1.5918882064819329,3.6883055877685464,cosmonaut,67,73,140
0.938016738891605,4.168062515258789,cottager,4,12,16
0.6371004104614215,3.5473346252441402,counter,3737,237,3974
0.36906551361083473,4.1880734405517615,courier,460,52,512
0.6273973770141481,4.4915419769287155,cousin,2123,509,2632
2.1451888580322276,4.378460273742675,coward,412,47,459
-0.70613115692138,4.209974845886229,cowboy,511,523,1034
2.404359466552741,2.906381546020512,crab,499,351,850
0.8809422225952019,1.734473808288584,craftsman,132,259,391
1.0865712585449145,3.2990894851684587,crawler,42,21,63
0.27819026184081963,2.1999421997070314,creator,2950,871,3821
3.5245407333374033,3.2785997619629086,creature,1566,1534,3100
1.3334594573974599,3.246568107604986,creditor,49,282,331
0.5021233673095722,3.618368247985842,creeper,61,18,79
-0.3806092453002847,0.9035820007324205,cripple,127,24,151
0.4318500671386687,3.788702507019046,crony,9,21,30
0.7828129959106533,3.2398288574218768,crossbreed,15,11,26
-0.13585611724853663,3.9669272079467675,crusader,424,719,1143
-4.434154937744147,3.8401135635375994,cultist,4,22,26
-1.096607437133791,4.193885177612302,cyborg,102,17,119
1.809785995483395,3.086696151733399,dancer,921,1857,2778
-0.8067883529663078,3.3346592483520467,darling,422,8,430
3.5311661987304674,4.490851425170902,debater,31,12,43
0.04517388153075075,2.467262458801258,debtor,50,156,206
-2.629734313964846,2.4758257446289136,decoder,16,4,20
2.930100860595701,3.5549880447387707,defender,1208,1711,2919
-1.3649440002441366,3.824639739990239,deist,23,23,46
0.7637027664184686,4.091360145568856,demigod,56,26,82
0.3339041748046867,3.3270603103637697,democrat,1048,2107,3155
1.2182591552734365,2.958318626403809,demon,1286,830,2116
-0.4260629882812452,5.3079748764038115,denier,26,74,100
1.5352787551879885,3.577987167358387,denizen,13,48,61
0.8718261184692295,3.275331260681142,descendant,584,1249,1833
0.3782229843139646,2.6969541854858434,descendent,53,64,117
3.118589378356937,4.377320114135735,deserter,44,163,207
0.7326667709350616,1.4006506729125974,designer,3003,1167,4170
-0.3716572494506849,0.8693430404663047,destroyer,2451,2839,5290
-0.06253331756591507,2.0054641494750953,developer,1287,2254,3541
2.239163261413566,3.7560609359741193,devotee,164,289,453
0.5827541580200162,3.2399447860717885,dictator,558,69,627
-1.7393966827392546,2.186080429077151,diploid,102,3,105
1.078304466247559,1.8221143417358405,director,16935,2898,19833
1.0339685592651264,4.056515029907217,disciple,228,397,625
0.49862907409668367,2.838908058166517,discoverer,126,90,216
2.117475204467773,3.861062782287611,dissenter,42,264,306
-0.2770702896118209,4.664375297546378,dissident,181,223,404
0.18612003326416016,3.118124771118161,distributor,538,299,837
2.6608926773071246,1.7643479843139644,diver,402,582,984
2.319000205993653,2.8975417861938553,divider,38,18,56
1.407834785461425,3.28466942596436,doer,8,11,19
2.8698900680541897,4.258716880798332,doubter,3,20,23
1.5970185241699184,2.8559884414672823,drawer,85,25,110
2.9101780776977506,4.214669120788564,dreamer,189,102,291
1.51085220336914,2.976531394958492,dresser,116,15,131
2.793647293090821,3.0837843933105518,dribbler,13,3,16
2.131577583312989,3.0753788299560654,driver,3170,2734,5904
0.1996128158569448,4.681948631286637,dropout,122,15,137
-0.18046504974365263,3.483125907897957,dummy,280,88,368
2.402627754211416,-0.9108600082397516,dupe,16,5,21
2.4348459472656288,4.334574661254884,dwarf,1530,191,1721
3.8263818969726557,4.134858314514155,dweller,49,146,195
1.3521773757934668,3.0136809768676827,dynast,18,10,28
0.5527295684814462,3.380705436706556,elder,2150,349,2499
2.4425255279541034,3.639699645996089,emcee,24,12,36
2.922891143798836,1.6669124374389526,emir,290,77,367
1.616428947448732,3.6076274185180566,employee,1165,3109,4274
-0.4392496337890677,4.013982582092282,employer,701,562,1263
1.6496671142578236,4.037494834899903,emulator,40,12,52
1.5107168731689455,2.1325635375976475,endorser,28,15,43
0.9549863281249955,2.8412089080810645,enemy,7687,3948,11635
1.9611264572143483,4.910659751892091,engine,7650,4212,11862
1.1274730529785089,2.445427192687987,engineer,4249,2635,6884
1.9908189315795894,4.308229187011719,enrollee,3,7,10
2.911000526428218,2.9431845626831077,entertainer,392,198,590
2.147220497131343,3.0187548522949186,entrant,130,162,292
-0.8774933853149278,3.9124184951782226,equal,3697,361,4058
0.6308933258056584,3.3094225921630738,estimator,6,6,12
2.2839301528930633,3.7131807708740254,eukaryote,14,223,237
2.194372184753419,4.336796691894541,ewe,73,102,175
1.525152931213377,3.772017959594727,exchanger,18,24,42
2.5791509552002054,3.7240230484008805,executioner,139,52,191
0.9752293701171908,2.4702009124755904,executor,108,81,189
2.07828296661377,3.4174642486572253,experimenter,47,34,81
0.6789593734741217,3.7379733963012782,expert,1548,1285,2833
1.0935951461792044,2.439214134216307,explorer,919,491,1410
0.8634664611816376,3.0131460647583026,exponent,147,94,241
2.8130832595825197,3.948534088134771,exterminator,13,10,23
-0.9758872299194365,4.295888160705566,extremist,114,105,219
2.269977928161623,3.307893325805672,face,10404,2002,12406
-1.0543545532226588,2.59510908508301,failure,5572,776,6348
1.3201731948852569,3.19862473297119,family,35185,5277,40462
-0.32478919982910526,3.8833401412963937,fan,5086,10304,15390
2.201799949645995,3.6004839859008797,farmer,1513,1784,3297
0.6434766311645461,2.7837717666625963,fastener,9,12,21
2.146712432861328,4.005640602111811,father,22373,728,23101
1.0476843872070347,2.9360939178466765,fauna,657,37,694
-1.802866271972654,3.923633773803715,favorite,3764,451,4215
-0.6139804458618272,2.6802575378417828,federalist,332,206,538
2.9078501510620143,4.541767738342301,fella,49,20,69
0.6458050842285274,4.488274940490712,fellow,6041,492,6533
-1.5017516937255877,3.8298276443481427,female,12596,4552,17148
1.8531360778808619,3.4296098175048826,fencer,41,8,49
0.25977699279785327,1.6062203903198196,feudatory,42,29,71
2.271451629638669,2.8413702850341807,fiddler,69,31,100
0.47053350067138666,3.957519371032724,fighter,5058,3343,8401
2.030902023315427,3.55541976928712,figure,7057,6255,13312
0.8584844055175793,3.261499153137194,financier,159,84,243
1.8799719085693383,4.06616609954834,finder,123,40,163
3.1937721786499083,3.52821720123292,finisher,218,162,380
0.9113118286132718,3.0081275253295914,flake,50,80,130
2.0446229095459003,3.9517469177246056,flatmate,20,10,30
2.4840657196044873,3.7404904174804656,flier,38,84,122
-0.6845150527953976,2.376828804016114,flora,883,18,901
1.4881012268066343,3.8456342391967766,flyer,226,597,823
2.9672052917480585,4.253495719909665,foe,270,292,562
2.1893201522827184,3.475490447998048,follower,240,1792,2032
2.7707446823120137,4.8716044769287095,fool,558,220,778
3.371776710510254,4.052348052978516,foreigner,132,542,674
0.3433620758056719,2.0792852630615215,forerunner,415,132,547
2.0452024765014585,3.6723751525878896,fox,8099,510,8609
1.1318060226440423,2.644886184692389,freelancer,63,18,81
-0.6849747619628914,2.9626895523071397,freethinker,15,5,20
0.49501924896241434,3.2243155517578117,friend,9824,10015,19839
0.11057196807860237,4.282141120910644,frogman,5,19,24
1.8634888992309726,3.0149683303832973,fucker,9,5,14
1.6812341613769632,5.175630851745609,fugitive,346,141,487
-0.6054515914916863,3.196241432189936,fuller,916,7,923
2.151074737548832,3.644845451354989,gambler,183,79,262
2.1207922973632805,4.207424942016601,gatekeeper,94,14,108
1.541617309570313,3.5566134033203127,gatherer,53,118,171
-1.5190094833374062,4.156325416564954,gay,4156,174,4330
0.6259981994628916,4.07764052581787,geek,285,60,345
1.066342086791991,2.324660018920902,genealogist,41,16,57
0.017871025085455017,3.839125350952152,genius,1206,75,1281
0.060076492309569574,3.9664966430663995,gentile,57,24,81
0.44085495758055515,2.286298423767093,geographer,144,30,174
0.47137691497801626,3.3015000076294,geologist,232,183,415
-0.8404921264648451,3.741350532531726,giant,4076,3129,7205
2.9404673767089946,3.627499511718746,girl,8590,5439,14029
1.358847244262698,2.5329885787963846,girlfriend,1844,135,1979
-0.08537596130371128,3.533021507263193,giver,51,9,60
-0.5252778320312501,3.970610931396486,gladiator,221,137,358
1.7401058349609357,4.901076293945309,goat,456,327,783
3.4953512878417925,3.9782480087280305,goon,52,38,90
-1.2935738601684577,3.915181015014646,great,31055,109,31164
3.924397041320802,4.4914161376953174,grownup,5,8,13
0.9807370986938508,2.7386002655029102,grunt,86,103,189
-1.04932008361817,3.3801307449340783,guardian,3158,442,3600
-1.272290557861318,4.371710273742671,guerilla,100,42,142
-0.38986243438721857,4.110504730224612,guerrilla,627,350,977
1.6865766220092766,4.973184715270996,guide,4317,735,5052
1.3638056869506912,4.329387901306156,gull,180,169,349
2.604560531616201,2.9444437408447257,guru,332,97,429
2.1571019821167,4.103532600402829,gutter,56,40,96
1.1030408935547058,4.369220512390122,hacker,216,83,299
-1.6204820404052782,1.1040489120483414,hanger,51,35,86
2.1882094650268513,4.523243019104015,hater,31,58,89
-0.3722542190551721,3.2548150329589802,head,21431,4830,26261
3.1866145935058583,3.6145842056274375,headman,34,23,57
2.3494964370727516,4.032074417114252,healer,107,29,136
1.8981766586303621,4.01491963958739,hearer,7,14,21
0.024696723937992715,0.8587060241699263,heathen,173,82,255
-1.404478660583493,4.161778205871585,heavyweight,1820,25,1845
-0.35470832824704956,4.042686592102058,hedonist,6,5,11
0.2071135177612291,4.053353576660157,helper,298,120,418
3.0133731918334945,3.9496399154662996,hero,5235,1872,7107
-2.416134284973147,4.540310058593747,heterosexual,280,24,304
0.9247214126586982,4.040823669433578,hobbyist,20,52,72
2.177488945007326,3.263193931579586,holder,707,609,1316
1.283862106323241,3.31582753753662,holidaymaker,3,14,17
2.815737213134767,3.82956087493897,homeowner,26,74,100
-1.0430356292724596,5.073847557067872,homosexual,727,287,1014
-0.9613759994506879,2.378994132995608,honey,1016,3,1019
-0.8817850570678658,4.4519423065185535,hopeful,260,26,286
0.8423946533203193,3.851751403808592,horticulturist,23,10,33
0.4065731506347632,2.3728736877441463,host,4855,2168,7023
3.4966699676513713,4.313460350036621,householder,118,43,161
-0.8348311233520462,2.736241088867189,hugger,10,3,13
1.1625289459228583,4.021017837524411,hulk,695,25,720
-1.5384041595458982,3.4191693954467652,humanist,232,24,256
-1.7868741455078165,4.269741012573242,humanitarian,705,6,711
-0.17430865478515756,2.950304229736325,humorist,48,13,61
0.5942934112548812,3.9245033111572454,humpback,115,33,148
2.1310830307006867,3.9143087463378876,hunter,2405,1345,3750
3.7350531387329156,3.057698776245111,husbandman,24,12,36
-1.8883582763671996,3.794509201049806,hybrid,1404,491,1895
-0.8556822662353483,4.3316047897338805,idealist,44,23,67
0.6290026855468867,4.025193656921388,ideologue,38,15,53
0.7140401382446271,4.590655494689933,idiot,257,75,332
-3.5314537887573323,3.2517427749633896,idler,24,11,35
1.0415503311157224,0.046546623229978934,illusionist,29,4,33
2.728677192687975,3.65588777923584,imam,168,35,203
1.7221462631225535,3.7664358139037972,imitator,19,68,87
2.30736099243164,2.9053902740478463,incarnation,560,200,760
-1.1127768707275436,3.7855646591186414,incompetent,247,7,254
-0.8853612976074174,3.99922668457031,independent,9332,204,9536
2.0182421493530214,1.8258098449707063,individual,9095,5814,14909
-1.352737503051749,3.730193023681636,individualist,68,4,72
-1.2025152130126884,4.12893788909912,inferior,883,10,893
1.2077634811401339,3.7060787734985254,infidel,39,28,67
2.783597434997567,5.1836835479736365,informant,197,95,292
2.9628828735351647,3.334962646484364,inhabitant,80,2425,2505
-0.4411016006469737,-0.1270775909423918,initiate,520,183,703
-0.20726058959960625,2.509470207214349,initiator,70,38,108
1.9954239501953168,3.2531294097900414,instigator,68,30,98
0.2162120666503924,3.296651580810547,insurgent,136,505,641
-0.7577446823120226,2.7376025238037087,intellectual,1618,375,1993
2.7331844100952267,4.457098915100097,interloper,11,7,18
-0.6984325408935561,3.6044399948120116,internationalist,102,10,112
3.504910339355469,4.542865005493162,interpreter,309,104,413
-1.850575401306159,3.3229442520141603,intimate,942,26,968
3.316362739562976,4.3428909454345686,intruder,170,146,316
0.5488407897949017,2.1444750976562545,inventor,450,97,547
3.30306584930419,4.162531890869161,investigator,315,689,1004
0.1416024398803728,3.660901298522951,investor,282,966,1248
-0.7601015319824214,3.7367476882934625,irregular,954,99,1053
2.1477234573364186,4.318118255615232,islander,205,587,792
-0.570575042724613,3.7159188003539967,isolationist,54,7,61
0.4154069137573302,3.591549377441403,jock,184,16,200
2.1709100570678714,3.372821617126455,judge,4872,1916,6788
2.747771736145012,4.0427990722656375,jumper,233,105,338
-0.17705622100829999,4.496187072753912,junior,4573,210,4783
1.3516785049438482,2.6493255157470657,jurist,112,80,192
0.6213077697753917,2.7539263763427755,juvenile,1216,771,1987
3.0758704910278283,2.4621638259887675,khan,2611,21,2632
3.640633277893059,4.0565693283081,kid,1678,2277,3955
3.5872894973754867,4.273784255981447,kidnapper,51,73,124
2.643182785034192,3.840437530517576,killer,2162,363,2525
1.713627975463865,2.446246498107911,kinsman,132,86,218
0.9384930496215844,2.8155092086792024,knocker,19,6,25
4.144502273559574,4.170423934936522,lad,452,79,531
0.48895221710205305,3.4978680725097675,lamb,1003,205,1208
2.9681385803222753,4.15067771911621,lawgiver,12,9,21
3.1117945785522494,2.060102294921876,lawmaker,21,116,137
2.2237332763671915,3.3488959503173845,layman,67,100,167
2.127464088439943,3.8965552444458,layperson,11,16,27
0.9208905639648464,2.098614051818849,leader,10593,6269,16862
3.150030662536615,4.514511383056657,learner,34,55,89
1.9277821197509653,3.4595815963745054,leech,216,48,264
-5.538716659545898,4.528637969970696,lefty,76,18,94
-1.1240957641601597,4.528208389282227,lesbian,1155,315,1470
-0.8791756210327151,3.1341242294311513,liberal,3578,829,4407
-1.2908939208984407,3.9812845230102596,libertarian,345,44,389
-1.066061340332034,3.024486152648926,libertine,40,25,65
-0.06930254364013422,3.732501914978023,linguist,135,122,257
0.8970860824584861,3.6655236587524413,lion,2318,1555,3873
2.7463673019409285,3.583344467163073,liquidator,14,3,17
2.6787916717529328,3.445478340148938,listener,493,910,1403
3.5935314407348713,3.4127961883544913,litigant,8,34,42
0.1601310653686454,3.5822087020873994,logician,9,8,17
1.9883618316650455,3.710609794616694,logistician,3,4,7
0.8992565460205171,1.9237783432006808,loner,89,9,98
2.942788856506347,2.9022492828369195,looker,7,4,11
1.1674918518066235,2.390065147399902,lord,9878,2043,11921
3.8249791946411165,4.369099372863765,loser,332,101,433
1.57757627105714,1.745682777404781,lot,6579,982,7561
2.6361813125610283,1.7906011199951166,lout,5,4,9
0.5997634124755891,4.220391578674317,lover,1724,878,2602
-0.4962257766723539,4.210204116821288,lunatic,154,37,191
0.6475482788085856,3.69874942016601,machine,7173,1647,8820
1.256340827941898,3.7277502441406227,magician,286,100,386
-0.7566501770019443,3.439034446716313,mailer,32,4,36
2.117836288452139,2.2139494705200065,maker,998,646,1644
-1.6413137359619085,3.847226936340334,male,9170,4774,13944
2.520222946167003,3.743314262390136,man,30762,32879,63641
1.6396765747070319,4.6358577651977555,manipulator,53,15,68
-1.158100524902352,4.260505165100099,marcher,83,105,188
2.0554046936035064,2.2754207458496083,mascot,689,140,829
-1.2970042037963836,3.40582878112793,master,6147,1962,8109
1.2887028350830008,1.8301117858886755,mastermind,125,23,148
-0.45353054809569926,1.8952564620971728,matador,71,9,80
3.2683974761962915,4.0001813583374,mate,1933,788,2721
-1.0152081375122037,4.017023208618163,materialist,37,3,40
0.15169141387939789,2.470993965148928,mathematician,445,244,689
-0.012985160827639675,3.2081103668212876,mentor,879,86,965
-0.8844936065673821,3.356170524597175,mercenary,329,507,836
0.40462848663330675,3.9634240570068258,messenger,644,245,889
0.23999816894531278,3.142847915649412,metallurgist,17,22,39
2.1711764526367148,2.1238461303711063,microorganism,17,150,167
-0.2434254150390558,3.678090599060063,midget,221,25,246
0.9536599578857476,4.388574012756351,migrant,271,387,658
-0.8083213729858301,4.435390777587891,militarist,16,11,27
-1.3944779281616277,2.012812393188476,millenarian,20,3,23
-0.02858905792236044,3.7891203231811517,millionaire,439,101,540
0.6195674438476644,2.9719852981567385,mineralogist,26,3,29
0.3227023620605536,1.8238551330566395,minor,9647,325,9972
-0.7562299499511766,4.952543365478519,misfit,45,68,113
-0.5776624603271472,4.51047026062011,missionary,872,796,1668
0.7270486373901335,2.2328057632446274,model,8931,4412,13343
1.1758648376465004,2.5484248046875138,modeler,7,14,21
-1.4907740020752058,2.8388803482055565,moderationist,3,7,10
1.1730523986816408,3.7052800903320318,modifier,12,23,35
1.2955600814819377,2.6860854263305782,mogul,81,44,125
1.8879339218139606,2.5571862258911153,moneymaker,14,4,18
-0.8113118209838888,2.9790370559692505,monolingual,23,3,26
2.330603874206531,3.1516842727661256,monster,2710,1545,4255
2.1200032196044916,4.474850090026862,moron,20,10,30
-1.2434220046997169,4.171351394653321,mortal,1050,66,1116
2.0307484817504857,4.903959762573244,motorcyclist,24,20,44
0.1324084396362295,3.7133211364746046,mountaineer,132,278,410
2.7639778976440468,4.2399359512329085,mourner,29,268,297
2.461101020812997,2.7180006179809695,mouse,1447,563,2010
1.6617742996215767,3.0064216690063503,mover,97,45,142
2.8264319381713747,3.6955761108398377,murderer,536,180,716
2.882536933898919,4.393881027221681,musher,18,66,84
-0.828831672668457,4.315841957092282,mutant,417,209,626
-1.555633834838865,3.0416712417602483,mute,191,17,208
-0.1590530395507912,3.945334259033203,namesake,443,19,462
-1.105235145568848,4.1048658905029285,national,45586,624,46210
-0.5449062042236292,4.027437927246083,nationalist,1439,581,2020
-0.45019150543213016,3.4916148681640564,native,8244,910,9154
-0.9346269683837889,3.2502598495483355,natural,10166,82,10248
-1.7457324600219692,0.6295165863037226,naturist,4,3,7
3.125975502014171,3.279572601318357,navigator,307,77,384
1.4022222747802715,1.9128309097290028,nazi,2747,791,3538
2.2662675857543917,3.425113510131837,negotiator,111,89,200
1.3472272109985397,4.204691551208505,neighbor,651,678,1329
0.740726524353029,4.173421569824214,neighbour,306,980,1286
1.5048566589355445,4.205586807250974,nerd,79,51,130
1.37838986968994,4.471997352600106,nestling,69,203,272
1.9148791732788126,4.659173072814944,newsman,16,6,22
1.8048432922363276,3.6707956237792985,nigga,33,48,81
-0.8386167526245032,3.160026321411131,nihilist,16,7,23
3.311947135925294,4.159911209106447,nobody,1284,26,1310
-1.1816316452026356,4.303117141723632,nonconformist,69,24,93
1.1297440643310566,4.782223342895506,novice,133,38,171
-2.883907173156736,2.6438352584838967,nudist,11,3,14
0.6543236389160114,3.06001019287109,numismatist,103,48,151
0.5587767639160148,2.7164609069824195,oaf,8,3,11
1.1481065826416028,4.08305587005615,objector,28,44,72
2.712469886779786,3.8057968444824297,observer,1706,1213,2919
-0.5357929382324187,0.02860617065429949,occult,282,4,286
-0.5233475646972536,4.1881454925537085,occultist,64,28,92
2.491331336975108,3.362267585754388,occupant,124,439,563
1.8842276382446315,3.5362076187133766,occupier,57,94,151
0.8161359024047812,4.216514282226569,oceanographer,26,7,33
-0.7822957153320331,2.9954006881713866,oddball,39,4,43
3.148516296386724,4.769576179504398,offender,149,200,349
-1.2712867355346589,2.8272623062133917,official,14224,7271,21495
-0.7633560104370147,4.175270492553707,offspring,959,8,967
-0.050992134094251185,3.018108665466322,oiler,77,513,590
2.2191144790649417,2.9847143859863294,opener,915,145,1060
2.6165974578857387,4.1021229171752935,operator,1272,950,2222
3.4893707504272413,3.521418571472168,opponent,2661,3149,5810
-0.46701282501221186,4.490540878295903,opposite,3650,104,3754
1.590297004699707,3.7119251937866196,opposition,5996,33,6029
3.5595184173583903,2.6077416381835974,organism,612,1676,2288
0.10767792510987562,2.0010612030029478,originator,73,32,105
1.5238517990112257,4.211279342651373,orphan,293,228,521
0.5175372848510875,3.5720700531005747,ostrich,104,34,138
-0.7474111709594737,5.092788581848147,outcast,132,115,247
1.1855538635253922,3.8140656967163054,outdoorsman,13,4,17
1.3467795944213847,3.979384330749511,outsider,288,219,507
1.3163779754638725,3.1224640579223575,overlord,411,94,505
1.8862898406982538,3.3965665969848615,owner,4043,3208,7251
-0.5826618423461909,3.883541641235354,pacifist,131,31,162
-0.43885417938231797,3.9473575744628917,pagan,1001,113,1114
1.8998577575683555,4.11983513641357,pal,393,79,472
0.022284042358400313,2.4214771575927614,palaeontologist,89,45,134
0.5889737930297798,2.376332847595215,paleontologist,237,212,449
0.5304357681274467,1.4063201522827242,pansy,16,4,20
1.5837110443115279,4.580512626647945,parachutist,10,35,45
-0.8667886810302718,2.6555349655151304,paraplegic,61,5,66
0.7943995208740233,3.003431343078603,parasite,480,689,1169
-0.9097074737548851,4.77094362640382,parent,1965,7259,9224
-0.2957295608520525,3.6007598419189435,pariah,37,4,41
1.047347816467287,2.5344017791748,parliamentarian,225,228,453
1.3988201522827026,4.277567939758299,parrot,485,274,759
3.4729624023437466,3.1148857116699205,participant,503,1763,2266
-0.8840416259765576,4.123994163513181,partisan,1034,924,1958
2.034652885437005,4.768594421386709,partner,3356,1725,5081
2.1168689270019527,4.714318885803216,party,26195,4288,30483
1.4888523941040077,3.426445198059085,pasha,580,8,588
-0.4517751846313516,3.61051232910156,passenger,3612,3795,7407
1.3033042755126942,0.9803625640869171,passer,272,66,338
0.32623407745361277,4.1897257690429655,pathfinder,69,45,114
2.1584953231811497,4.387915740966797,patient,1587,2039,3626
-0.20108946228027236,4.462782394409189,patrician,91,102,193
1.3274912033081065,4.434838760375975,patriot,574,635,1209
2.325297622680665,4.197034629821772,payer,32,28,60
-1.6292668457031212,4.357342857360841,pedestrian,581,236,817
0.06735642242431794,3.1144997406005857,peer,556,986,1542
-0.6703275909423922,3.973510391235351,perfectionist,145,9,154
2.940806503295896,3.380171524047846,performer,1139,1440,2579
0.1464287567138598,2.639186897277831,person,11675,49224,60899
3.234319480895998,3.2744084091186565,personage,31,38,69
0.4506612930297962,3.189485160827637,personification,141,32,173
-2.2122777633667,3.456145278930663,pet,980,387,1367
3.540549156188966,3.766329841613775,petitioner,56,66,122
-1.1503938522338828,3.7054519348144552,philistine,31,30,61
0.37419468688965907,2.538883712768545,philosopher,1071,527,1598
-0.08073403167724535,1.8274121170043998,physicist,630,364,994
-0.7268509597778348,3.680217651367194,picker,36,35,71
2.745293487548828,3.995989372253412,pitcher,1788,547,2335
1.611125137329097,3.2124233398437454,planet,6078,2394,8472
0.9683326721191392,1.9235173339843783,planner,153,377,530
1.3094708099365207,3.485150863647462,plant,7415,5599,13014
-0.7954655380249065,3.651418548583983,planter,112,105,217
1.084358291625982,3.5310599746704057,plantsman,4,7,11
3.238526939392088,4.161972999572754,player,27922,20973,48895
1.9524904251098576,2.386888992309572,pleaser,25,3,28
-1.2412478561401485,3.674663536071783,plebeian,172,114,286
2.2055336914062593,2.96588885498047,plotter,27,166,193
2.584305152893066,3.9231804122924814,poisoner,18,7,25
1.5227132720947338,1.555577117919924,politician,1622,1734,3356
1.9248189315795798,2.9125244522094675,polymorph,13,7,20
-2.2732939071655167,3.4718731231689546,polyploid,10,7,17
-0.7476099243164143,3.852647727966314,populist,280,44,324
-2.1424579772949244,3.412124427795412,positivist,36,15,51
2.5126377639770396,3.8088473510742205,possessor,44,12,56
1.461695472717281,3.1298833541870152,poster,893,675,1568
2.199242950439448,2.838396797180174,potentate,5,13,18
0.1620679779052736,3.129903121948246,powerhouse,224,22,246
-0.28957920837402185,3.4149703445434554,pragmatist,16,11,27
-1.0172770843505816,3.7024181213378924,prayer,1689,515,2204
-0.06742378997802234,1.8188738327026286,precursor,807,238,1045
1.1235116195678714,2.215061431884763,predecessor,2358,1121,3479
2.5318647766113287,3.3526491241455076,presenter,374,82,456
-1.4897691802978414,3.1877884063720714,preserver,23,8,31
0.07058962249755751,4.317366760253904,preteen,22,4,26
-2.5014504241943314,3.4569419174194422,primitive,1094,31,1125
3.6284523696899527,4.110052970886223,prisoner,2082,4335,6417
2.6515525588989277,3.6200660018920843,processor,369,188,557
0.8131994476318454,1.275240776062013,producer,10663,5972,16635
-1.0496740188598537,3.738414237976073,professional,9659,775,10434
3.170715782165516,3.9804640579223616,profiteer,4,8,12
1.7547877044677733,2.0285410766601544,programmer,376,275,651
-0.8097819366454999,3.716804000854488,progressive,1974,66,2040
2.049683654785163,2.5872050857543982,prokaryote,8,103,111
-0.6896123504638609,3.355778213500976,propagandist,62,27,89
-0.12233654785156745,3.8045578079223574,propagator,4,8,12
1.6679013748168856,2.660316734313959,prophet,560,211,771
0.1484721145629848,3.9956025161743156,proponent,358,467,825
0.9362251358032267,2.634693443298339,prospect,1495,695,2190
4.220736465454102,3.787996345520021,protagonist,2821,726,3547
-1.3697986450195287,0.7692050857543862,protectionist,83,16,99
-0.5245400848388542,2.7969567794799843,protector,494,89,583
1.286801330566405,3.5882406463623084,protester,79,834,913
-0.03271104431152594,3.687487098693829,psychic,426,13,439
1.1136505813598632,2.2468014984130846,publicist,216,26,242
1.0518753509521517,2.875581291198742,pugilist,10,9,19
2.660991699218748,4.158301383972173,puller,70,5,75
3.788004501342769,3.8926931838989276,punter,140,15,155
2.1855825042724604,3.729217048645019,pupil,643,1177,1820
-0.5910059738159248,2.8174837188720687,puppet,757,391,1148
3.6867287826538018,4.843125778198242,pursuer,34,129,163
1.8189192810058614,2.6353402633667073,pussycat,98,10,108
-1.8793036346435628,0.9696954040527359,pygmy,309,12,321
0.6776595001220613,3.8586440734863316,qualifier,295,178,473
-1.6977298126220575,2.6249522247314445,quarryman,7,121,128
2.4411042709350497,2.877826759338376,queen,11098,1166,12264
-0.7399483489990146,3.2419205932617174,radical,2099,337,2436
1.4924314880371128,2.8382045440673878,rafter,39,110,149
1.768877876281742,2.9386233596801645,ram,1117,524,1641
1.4000140228271576,4.436589752197278,rambler,46,31,77
0.6997243804931657,3.9891103973388695,rat,917,913,1830
-1.162218551635732,4.698496490478519,rationalist,56,5,61
2.0239915313720758,3.338935379028321,raver,26,3,29
2.5651984863281214,3.4444095916748054,reader,1645,2530,4175
-0.4822206497192383,3.1572426300048946,realist,175,20,195
1.8911322708129887,3.1045608444213997,receiver,1075,346,1421
2.0394213867187503,3.5597363967895532,recipient,942,539,1481
-2.31475862121583,2.692414260864261,recombinant,53,3,56
1.7282350616455062,3.14841191101074,rectifier,19,24,43
-1.6480127792358417,4.330157989501949,recusant,19,29,48
-0.1829987792968737,3.344013732910156,referral,69,12,81
0.6568795242309662,2.4253322982788106,reformer,262,373,635
-0.3589009323120109,3.694775566101079,reformist,152,26,178
2.8253395080566293,3.5788539657592793,regent,858,329,1187
2.101614356994638,4.04948757171632,registrant,22,13,35
-0.08777841186523716,4.524606819152822,regular,10127,541,10668
-1.458219116210934,3.3186841888427736,relative,3500,1927,5427
-2.3254175491332987,3.396172630310062,relict,45,6,51
3.2582582626342784,3.5029974670410127,reliever,130,38,168
-1.064213081359867,4.52242800140381,renegade,168,60,228
0.9716978378295948,3.5516283721923827,repeater,23,24,47
-0.20069287872313168,2.922545288085942,replacement,3695,469,4164
1.7947580032348611,3.206399246215817,reporter,2158,960,3118
-0.1916487960815516,1.3490293884277236,representative,3604,3665,7269
-1.3284854965209973,3.1448835525512777,republican,5703,1900,7603
3.1588728790283156,4.534605972290038,rescuer,35,129,164
0.4602490539550814,3.3534970474243195,researcher,573,2025,2598
-0.6352164535522462,3.341676223754881,resident,2894,6817,9711
-0.6349071197509772,4.267807945251462,resister,7,31,38
3.6669319076537974,3.610837463378907,respondent,74,285,359
2.491136009216312,4.170153030395511,responder,19,53,72
1.4553282928466658,2.7320641174316407,retainer,72,113,185
-0.9700204772949235,-0.14007865142823306,retard,29,9,38
1.974306228637701,4.455898307800297,retiree,6,30,36
2.629756942749026,3.8148238067626963,revenant,77,17,94
-0.9905774307250965,3.5549549942016583,revolutionary,3007,415,3422
0.8634016342163022,4.127314819335936,revolutionist,13,9,22
3.029621932983403,4.327367675781247,rider,1748,2746,4494
2.438512466430666,3.585533004760741,ringer,61,34,95
2.7615560989379873,3.8900422439575237,riser,34,15,49
0.2839266662597666,3.9510339660644576,rival,3393,1796,5189
0.8530231704711966,3.722789268493642,rock,20733,2453,23186
-1.24206748962402,2.0606452407836926,romanticist,20,4,24
2.1871555557250986,4.1997258987426775,roommate,220,69,289
3.694167266845696,3.690812019348151,rounder,239,35,274
2.6838441619873024,3.936217231750483,rover,243,1019,1262
2.576115287780766,2.8390001068115325,ruler,2020,1278,3298
-1.4481715393066423,4.924100105285646,runaway,369,62,431
1.0722046279907218,3.1472271499633777,runner,1782,1214,2996
-3.295156631469723,2.667223495483398,runt,25,3,28
3.1710063095092735,4.088019264221202,rusher,124,44,168
1.8298358917236328,3.2680846023559624,sacrificer,4,3,7
3.564474266052244,2.3834329910278313,saint,7507,1553,9060
1.668625473022459,4.597443664550781,salvager,4,6,10
2.3304382705688482,4.311989906311034,salvor,4,7,11
-0.4427110061645507,3.2171379623413117,samurai,255,4,259
-0.4144175643920889,3.9906207427978586,satellite,2778,536,3314
-1.1891427383422837,4.081284919738756,savage,1243,89,1332
-0.4962596817016589,2.2194117736816423,saver,22,14,36
0.9662199554443376,2.8731166229248046,savior,197,18,215
1.1359066085815428,3.675961318969726,scab,14,15,29
0.41364690399169746,2.5657869262695314,scalawag,4,10,14
1.691064338684086,3.337237602233884,schemer,14,4,18
0.5316874694824207,2.371044227600109,scholar,2260,3394,5654
1.3402123565673776,3.134221557617174,schoolfriend,14,4,18
0.9089652557373,4.383870971679684,schoolmate,43,54,97
1.1989390792846635,3.0518885955810546,scientist,1552,3121,4673
0.890955604553227,3.2094009017944316,scorpion,175,121,296
2.9032183761596713,5.134041419982907,scoundrel,25,35,60
1.7581207427978498,3.012222816467286,scourge,62,5,67
-0.32115605926512814,3.1345792770385756,scout,1937,1222,3159
2.207382957458499,1.6090815734863284,screamer,6,13,19
1.2679669799804643,4.014198127746589,scrubber,7,7,14
-0.527333763122563,4.7279944915771495,searcher,25,49,74
-0.8523080978393551,3.763797058105446,secessionist,90,29,119
-0.8526424407959041,3.016026145935058,secular,1092,3,1095
-1.3910756988525392,4.471068107604978,secularist,9,7,16
1.2663378829956002,4.712513488769531,seeker,96,196,292
1.4475091629028327,4.189446487426757,seer,72,13,85
2.3227661361694345,2.7709936294555604,selector,111,417,528
-1.0809844131469646,3.3380629272460993,self,10629,83,10712
3.1726329574585037,4.020053749084482,sender,40,11,51
-0.7847812805175707,4.763110763549804,senior,6947,291,7238
-0.1225010604858312,3.3879601593017554,separatist,154,73,227
0.9218031234741204,3.2715778503417994,servant,932,1108,2040
2.2406629180908197,3.5903110656738235,shaker,89,36,125
2.6165924072265625,3.803470726013188,shark,3428,2071,5499
3.4882098541259765,3.9284862518310533,sheik,80,16,96
3.0192972183227624,2.1220776748657215,sheikh,311,55,366
1.3994518051147367,4.533365913391108,shipowner,12,17,29
2.060766265869141,4.459594848632811,shooter,949,311,1260
1.0091823883056463,4.084864837646485,showman,80,12,92
-0.30252451324462015,3.258256019592288,shrimp,352,67,419
-0.19838818359374955,3.710808845520006,sibling,242,1035,1277
2.1371774291992196,4.579370941162111,sidekick,199,33,232
1.7462369461059524,4.2096084060668915,signaller,15,43,58
0.07963842773437335,2.664408988952644,signatory,107,183,290
0.8868632583618208,2.786368537902831,signer,38,121,159
1.6815164871215913,3.399296600341799,sissy,18,3,21
3.360336296081556,3.852640892028809,sitter,144,33,177
2.0315175933837963,4.620367202758793,skeptic,108,102,210
-0.3122155838012617,3.687666450500487,slave,2202,2469,4671
-1.3398664321899503,3.6555451507568435,sleeper,244,101,345
2.3443360671997198,3.041084365844725,slider,124,28,152
2.5505744628906157,3.564589210510249,slinger,8,12,20
2.229228424072261,2.308376815795917,smith,11915,209,12124
1.5927147750854473,4.259355743408193,snake,1742,725,2467
3.4835795898437496,3.5509060058593747,snatcher,22,40,62
2.941655479431155,3.2625116424560545,snowboarder,20,10,30
3.2523821563720716,4.172001296997067,sorcerer,270,50,320
0.5705610427856413,5.333805053710925,source,8045,6796,14841
1.3693940734863332,3.0720363922119205,southpaw,21,3,24
1.789065658569335,2.3330970993042044,sovereign,1265,128,1393
2.648270515441901,3.683458656311039,spaceman,67,7,74
0.36890554809570375,3.2792764205932556,spade,86,65,151
-0.5452414855957031,3.2988261489868123,spearhead,131,42,173
0.3411067504882723,3.0224665908813364,specialist,1207,385,1592
0.7030844421386675,2.743269210815427,specifier,3,5,8
1.3568060531616126,2.108345336914063,spectator,442,1348,1790
1.1203999023437419,3.7199097137451176,speculator,54,105,159
2.147640701293959,2.4685083618164043,sphinx,61,8,69
1.6705851821899387,3.5979338226318305,splitter,45,13,58
1.5071211471557646,3.9726622314453053,spoiler,78,67,145
1.9639094161987316,2.8849310150146508,spokesperson,608,19,627
0.1271223678588953,3.0342290420532336,sponge,263,274,537
1.3623713378906288,3.458771591186526,sponsor,723,507,1230
1.8426471328735374,1.379855712890624,sport,3920,7486,11406
-0.009442642211908492,4.442529975891119,spotter,78,53,131
0.5750099563598781,4.090241127014153,spouse,154,127,281
0.5885783996582035,4.325142890930181,stakeholder,14,78,92
2.6897593231201142,3.9478771362304883,star,22042,11432,33474
0.2676097488403286,3.827301345825198,starter,928,237,1165
2.473451644897459,4.360648895263672,steward,350,201,551
2.7556005477905288,3.647966270446787,stooge,15,110,125
3.2334944305420024,4.8632857742309525,stranger,707,303,1010
0.38619694519042014,3.2431716537475594,strategist,116,46,162
0.5528563308715917,4.371982864379881,strikebreaker,3,27,30
2.238940162658693,3.5418811874389604,striker,1037,273,1310
2.0341875915527226,3.115607231140139,stringer,86,22,108
0.5470338668823231,2.7827784042358346,stripper,146,102,248
-0.46985920715331986,3.893547592163081,student,7009,11675,18684
2.030405395507813,3.7101589202880803,subject,8316,2649,10965
-0.3859135665893447,2.0382403793334873,substitute,1824,209,2033
-1.1678084564209001,4.091153404235847,subversive,235,16,251
0.25796168518066764,2.316975799560545,successor,3119,590,3709
2.6932172088623005,4.080361373901354,sucker,150,71,221
3.3217430114746094,4.815281097412104,sufferer,47,77,124
-1.0804615936279305,3.202804168701171,suffragist,43,45,88
1.8455649261474605,2.498791442871088,sultan,1768,71,1839
-0.0829854660034286,3.492968330383299,superior,3078,408,3486
1.9955075454711846,1.806956756591795,superman,1174,18,1192
-1.3036933364868162,4.277935317993162,supernumerary,38,8,46
2.381332481384277,3.8568387985229577,superstar,488,287,775
1.278906066894514,3.417901336669928,supplicant,7,7,14
0.15953224945067035,3.4241724777221663,supporter,1286,4151,5437
1.534245750427246,2.987991424560562,suppressor,39,11,50
-1.4857928390502977,4.3499268951416,supremacist,57,19,76
-0.18040679931640824,2.626133949279776,surveyor,413,111,524
0.34888397979735686,4.219835411071784,survivalist,5,4,9
0.8288007431030167,4.321304832458502,survivor,1246,2755,4001
3.7327391738891507,4.454993972778318,suspect,1121,795,1916
0.19556307220459246,2.398726661682133,sweater,156,45,201
1.8424878311157329,4.626580505371095,sweetheart,241,36,277
3.5546087493896508,4.8734079742431575,swimmer,508,319,827
1.9632799835205077,3.9790848388671733,swordsman,71,20,91
2.1344540863037125,4.195761154174804,sympathizer,60,168,228
-1.1008731155395495,1.6887537384033209,syndicalist,55,22,77
1.9798024291992178,4.026387069702146,tactician,53,17,70
3.236083465576172,2.554915397644052,tapper,29,4,33
2.073650451660157,-0.9747806320190477,tease,115,55,170
0.34960042572020456,3.460266365051268,teaser,488,43,531
1.5471592483520524,3.1286672210693354,technician,275,319,594
0.21100731658935246,3.4380068893432565,technocrat,5,8,13
2.5351003265380854,3.2839598312377873,technologist,12,8,20
2.2686681289672848,4.088279479980457,teen,1277,435,1712
4.195782180786132,3.8328652648925754,teenager,893,666,1559
-0.8676171188354473,3.2195906219482424,teetotaler,24,4,28
1.2047275848388637,1.9421876449584872,terror,1019,48,1067
-0.5712024383544971,4.063559860229482,terrorist,911,385,1296
0.4204719390869158,2.5424868087768573,theoretician,27,8,35
-0.08060590362548936,3.8902528457641594,theorist,250,270,520
2.1389119338989317,4.099004783630363,therapist,159,61,220
0.29021709442138643,2.4037057495117296,thinker,129,202,331
-0.09119157409668333,2.5111449661254994,thoroughbred,319,119,438
3.0260132827758923,3.581316673278806,thrower,72,163,235
1.5859438934326207,3.7661402053833015,tiger,1842,1700,3542
-0.8751165847778424,2.3931214294433474,tinker,300,11,311
0.1899341125488263,1.3610342864990201,tool,1291,1731,3022
1.5819255599975577,2.1850031738281146,topper,138,24,162
2.698639038085936,3.599583396911626,torchbearer,9,6,15
-1.0815451660156228,4.132643745422364,tourist,1593,1453,3046
0.6684200668334981,3.9834154281616136,townsman,3,26,29
2.2838386611938404,3.5240943298339857,trainer,694,326,1020
-0.662453704833986,3.6815269775390647,transfer,4003,437,4440
1.832165473937991,3.53745750427246,translator,340,110,450
2.270556831359876,4.571915100097662,transmitter,237,115,352
-1.2370197677612396,3.9307756500244153,transsexual,67,12,79
0.26249775695800537,3.457360855102543,transvestite,33,14,47
2.146279556274422,3.0779730987548817,traveler,264,565,829
2.319852935791019,3.123487144470218,traveller,338,296,634
2.3637499008178793,3.0651675720214797,treasurer,664,19,683
1.8983464126586895,4.1968464202880895,trespasser,14,35,49
0.7390922164917129,3.5277862777709856,trimmer,191,23,214
2.142538032531739,4.875733253478998,troublemaker,49,21,70
1.5188188552856445,3.495548042297365,trustee,438,1088,1526
-2.1781418838500954,4.268287185668946,turncoat,14,5,19
2.9666852722168002,2.6179947280883766,turner,2043,10,2053
3.2780207366943372,1.9244984283447266,twin,3171,1065,4236
1.8257851181030134,4.547325088500983,tyrant,321,108,429
1.3499307708740318,4.818486106872548,unbeliever,11,27,38
-0.26989218139648585,4.249882377624509,unionist,175,134,309
2.0012297668457038,4.023171791076663,user,1624,2111,3735
2.5562890319824163,4.867457801818837,vacationer,3,18,21
0.32579663085937227,2.9499399108886735,vassal,359,179,538
-0.2612026672363186,2.512169357299804,veteran,1797,1772,3569
3.3360699691772595,3.4982765960693314,victim,1791,3195,4986
3.2653482894897508,3.953916908264155,victor,2341,166,2507
2.0827405395507697,3.4496272888183483,viewer,1001,7379,8380
3.1428054885864327,3.5515383605957,villager,61,671,732
3.0091616439819404,3.76897561645508,villain,1466,866,2332
-0.22183652496337913,3.796125335693361,virgin,2202,77,2279
-0.9435522613525436,3.4562784194946303,virtuoso,179,9,188
-0.40103787994383566,3.2333401489257767,visionary,215,11,226
0.3646580581665049,3.397382598876952,visitor,1018,3227,4245
-0.8944749679565405,3.9132107925415056,volunteer,1614,2063,3677
1.8333645553588838,3.43467002105713,voyager,815,13,828
2.7949699325561426,3.325616851806643,waiter,176,51,227
2.5495248641967834,5.022497299194342,walker,2773,235,3008
2.4880072555542085,4.4638272094726545,wanderer,101,815,916
1.0066035385131755,4.083204940795902,wannabe,103,16,119
-0.15743435668945693,4.020383316040046,warhorse,7,8,15
-1.115594818115234,3.6438629531860443,warmonger,7,3,10
0.2967170333862299,2.94224546813966,warrior,1570,1986,3556
-0.9596063079833996,2.760031585693362,washer,32,10,42
1.4788162384033186,3.5298099899291984,wasp,566,371,937
2.6452794189453215,4.463149627685553,watcher,67,93,160
1.0686063766479492,2.918990425109854,waterman,75,7,82
-0.31277949523925486,0.38288100433350536,waver,40,10,50
3.109899147033687,3.8617197723388728,wearer,94,16,110
1.1059839019775382,3.3456540374755974,weasel,198,78,276
2.2786299514770505,4.429849205017092,westerner,27,114,141
2.4283198394775383,3.9036513137817366,whale,1677,1475,3152
-0.26910423278809503,3.1938919754028348,whiz,34,3,37
-1.5046975021362314,2.2634304199218818,wimp,9,4,13
1.5663682174682592,3.997695167541508,winner,4292,1990,6282
2.1835663757324255,-2.321680442810056,wiper,3,17,20
1.6025004806518481,3.268224021911621,wisp,19,13,32
1.588266632080078,3.452749191284177,witch,1227,594,1821
0.03933368682860561,3.2373074722290056,witness,1586,1783,3369
3.061882629394532,4.033170158386234,wizard,754,433,1187
2.4116100540161227,2.2612431182861314,woman,11305,21958,33263
0.5874755096435536,3.2331620788574185,worker,1509,6464,7973
2.344876831054691,3.333299011230473,workmate,4,4,8
3.3651459579467797,3.841969802856447,worshiper,9,56,65
2.730025299072274,3.9360047225952215,worshipper,25,112,137
2.1492636871337893,3.517606170654311,wrestler,969,1096,2065
0.41755769348144156,3.8805809936523445,writer,11195,8004,19199
2.989227523803713,3.0395935668945313,wrongdoer,8,5,13
4.085302215576171,4.586363433837889,youngster,110,118,228
2.838562728881847,3.457540740966799,youth,5056,301,5357
1.541571289062496,4.188596313476559,zealot,22,28,50
-1.3439223861694387,4.712974342346193,zombie,601,342,943
2.3478971252441454,3.554557785034177,zooid,17,73,90
