s,p,sent,s_freq,p_freq,freq
5.148964813232425,0.5236587829589823,abductor,15,19,34
1.1737211456298837,1.9085538787841756,aboriginal,830,72,902
3.985272171020519,3.024430915832518,aborigine,20,235,255
3.4241390838623005,1.838771568298327,absentee,111,6,117
1.8401697158813448,-0.6947310638427737,abstainer,4,4,8
3.4877247619628946,0.42442300415038403,accumulator,26,24,50
5.179382545471192,1.6087463684082053,accuser,39,38,77
5.860425071716307,1.8098233261108305,ace,1494,295,1789
5.01908428955079,2.8592422409057434,achiever,25,6,31
5.078360916137683,0.2851092834472766,acquaintance,373,218,591
4.511737052917482,1.990475036621092,addict,145,72,217
4.229561012268064,1.4739114837646454,adherent,66,352,418
4.9877845840454285,-1.0386772308349634,adjudicator,11,5,16
5.1335726928711125,-1.284731903076171,administrator,782,492,1274
4.7698663787841795,0.6531086349487225,admirer,270,182,452
4.015113967895509,3.7495760803222566,adolescent,335,209,544
3.9947908477783187,3.0189445037841764,adult,5529,3574,9103
5.91674011993409,2.4382082595825167,adventurer,192,152,344
5.035688522338859,2.566036140441902,adversary,196,197,393
4.9513076858520435,-0.16693206024169882,advocate,1365,653,2018
4.618103355407719,-0.5149062500000028,agent,5241,3117,8358
3.829564163208005,0.695008514404293,aggregator,443,12,455
4.765263648986817,1.6053850097656195,agnostic,128,33,161
5.004084106445305,0.5832405395507863,agonist,74,65,139
3.1453501815795946,-0.7622017135620212,albino,85,11,96
5.088613090515139,0.5006723861694269,alchemist,112,43,155
3.8551752243041904,0.36831730651854855,alien,3286,1309,4595
3.043233253479002,-1.2430420989990267,allocator,40,39,79
3.8637721252441466,1.5538415679931674,amateur,2233,232,2465
3.9830554504394584,2.871843132019052,amputee,59,28,87
5.2346177673339795,-0.683454856872558,analyst,462,549,1011
4.321725837707518,1.6141399230957134,anarchist,566,321,887
5.167639801025388,-0.37097078704833564,anatomist,72,47,119
3.5816065902709937,-0.06768208312989543,anatomy,1085,3,1088
4.068976196289057,1.9033173446655454,ancestor,931,1088,2019
2.0756787719726546,0.6347578048706026,ancient,6622,134,6756
4.210785064697262,0.3549667282104494,angel,2602,1354,3956
3.7979861221313485,2.581060546875001,animal,5978,7775,13753
5.353467193603514,0.3198375167846734,animator,391,736,1127
5.224700790405265,-0.4497087783813427,announcer,324,99,423
5.43179386138916,1.2432958221435655,antagonist,884,345,1229
5.486175788879407,-0.3949434814453099,antiquarian,296,37,333
5.370220123291027,0.6103093261718726,antiquary,61,75,136
3.978011497497569,1.8035808792114238,ape,207,372,579
4.7671269836425765,0.01578263854981543,apologist,31,24,55
4.302797157287593,0.3692512207031342,apostate,27,9,36
5.905845603942872,3.773192489624023,applicant,269,385,654
5.334376037597657,1.8253910598754999,appointee,73,147,220
4.726375709533691,-1.3480356369018551,appointment,2742,656,3398
5.079194351196293,-0.48976873779297136,arbiter,248,22,270
4.371588668823243,1.2724924011230527,archer,950,324,1274
5.334556747436537,1.0072525329589794,architect,2373,1256,3629
4.9165342788696265,-1.052267044067392,archivist,71,13,84
5.524046424865723,1.3740421829223521,aristocrat,138,191,329
5.119454978942869,-0.6599890518188474,artificer,12,7,19
5.39181163024903,1.5415819320678636,artist,9094,7385,16479
5.067765243530282,1.9954607009887653,ascetic,142,50,192
4.522423599243162,3.0851655731201078,aspirant,29,15,44
4.162899238586434,-0.40764502716064044,assignee,10,5,15
3.8475210113525407,0.5391977005004875,assistant,5266,498,5764
4.3131474914550765,1.0652852401733384,associate,1675,1268,2943
4.200945327758788,1.2954076919555746,asthmatic,33,5,38
4.995996200561521,2.7357582702636734,astronaut,433,438,871
5.124333808898925,3.1210703659057515,athlete,1335,2410,3745
2.771396209716791,0.4343298339843713,attraction,1582,735,2317
5.080149642944335,-1.2258442535400391,auditor,184,97,281
5.695896965026854,0.17623790740967138,author,7640,3461,11101
3.6196001663207937,-2.281709510803232,authority,7524,5340,12864
3.531265892028813,-0.18633347320556481,automaton,39,43,82
4.474460311889651,1.1441492004394576,avatar,888,182,1070
4.61182277679444,4.467075637817381,baby,4303,480,4783
1.5899351272583004,-1.8433603057861276,balance,2775,122,2897
5.483277175903318,0.29505923461915273,banker,372,252,624
4.60787650299072,1.744583084106445,barbarian,318,163,481
2.690632904052734,1.9512442016601526,bather,7,25,32
5.370056045532223,2.5140738449096673,bearer,374,150,524
3.833764106750486,1.4979223175048872,beast,1214,238,1452
5.4966374130249065,2.8543299789428715,beater,46,11,57
5.070845710754391,2.5232625350952134,beginner,59,78,137
4.702773918151848,2.7161094589233414,behemoth,83,3,86
5.192634437561033,1.3193477783203136,beholder,54,3,57
2.4048278427124004,1.57881784820556,being,69128,978,70106
4.904555961608892,2.6647034759521517,believer,355,228,583
4.923680580139155,3.553402473449694,belligerent,111,42,153
3.5627098083496094,1.6881389007568401,beloved,547,4,551
5.713312255859385,0.6173912811279294,benefactor,187,94,281
5.259294876098636,3.315680412292494,bidder,118,56,174
5.845092720031737,1.8447637023925836,billionaire,174,31,205
5.062012268066411,0.12831397247314413,biologist,293,237,530
3.04516688537597,2.9142124633789166,bisexual,298,9,307
5.5828890762329095,-1.9408038024902439,biter,12,4,16
2.4959697952270545,0.46750163269042844,bleacher,42,88,130
5.421959625244135,0.20475407409668378,blogger,162,89,251
3.071568496704103,2.0231780471801812,blonde,641,31,672
3.7739839630126966,1.2790495529174848,boater,9,57,66
2.4549258804321212,1.8795858764648443,body,17987,5562,23549
5.394712348937993,1.580487289428703,bodybuilder,30,5,35
4.740375595092786,2.4652320861816364,bomber,2167,2884,5051
2.806903839111328,0.17948035430907794,boob,11,18,29
3.947517021179202,0.6798688964843649,bookmaker,37,73,110
3.8652614364624043,3.7072241897582927,boomer,66,27,93
4.393166023254402,2.5416632995605397,booster,281,98,379
5.5957087173461915,-0.005695602416992074,boss,2156,471,2627
5.222442832946776,1.6575620193481413,boxer,550,129,679
5.30777087402344,1.2491811752319393,brawler,28,5,33
4.739506919860844,0.42858781433106685,broadcaster,515,297,812
3.609818389892581,2.781402305603031,brunette,74,5,79
5.044859909057635,0.27652134704590026,brute,186,45,231
4.889333816528321,2.2867430419921817,buddy,424,46,470
3.1204870529174755,0.2485541610717803,buff,458,42,500
5.061003952026368,0.18226491546631252,builder,492,431,923
4.27915843963622,1.3246414108276312,bull,1696,585,2281
5.69035213470459,0.8454068832397539,bullfighter,18,5,23
4.148833702087387,1.3573861541748045,bum,81,24,105
4.8829950103759785,1.6199345779418906,businessperson,16,37,53
4.294657226562499,2.9007683181762687,busker,7,3,10
4.698111747741706,1.4560207901000979,buster,238,265,503
4.639067283630368,1.4190345077514621,caller,146,39,185
5.994410095214839,2.1919159545898452,candidate,4275,2755,7030
4.6615565643310575,1.3857932815551806,capitalist,358,85,443
5.068317771911609,1.3565034332275445,captain,13626,805,14431
4.230735748291025,3.675301017761228,captive,1064,352,1416
5.947380302429188,1.1740077438354461,captor,36,210,246
4.950411849975588,1.0410432891845716,caregiver,173,125,298
4.3786643829345735,3.429672515869143,carrier,3591,2397,5988
4.87996898651123,-0.3604582519531192,cashier,63,6,69
5.669880279541019,2.9633822402954095,castaway,36,34,70
4.774317199707028,-0.1006225891113317,caster,29,9,38
4.530153549194331,-0.6391624679565382,catalyst,402,145,547
0.9515054168701198,2.5484074401855423,category,6389,1759,8148
5.105613899230967,3.3017943115234374,celebrant,13,3,16
5.520665153503408,-1.7536486358642591,censor,285,313,598
3.8775189208984386,0.9479203567504797,centrist,68,7,75
5.203383903503422,1.099935272216797,centurion,169,43,212
5.112616432189952,3.5111302032470704,challenger,456,153,609
4.6149122619628855,2.983213912963876,chameleon,74,27,101
5.3408555221557705,2.9661974868774337,champion,5322,4183,9505
4.023789611816412,1.6802199249267602,changer,48,22,70
6.066260650634746,2.1628849411010833,chap,46,23,69
4.901454879760742,2.6816962661743204,character,34343,20753,55096
5.325304229736325,-0.49639778900146325,charmer,33,6,39
2.617685539245599,2.2530235519409274,cheerleader,180,94,274
5.138832939147946,0.8365899505615246,chemist,427,188,615
2.762331268310554,2.039878646850596,chicken,1204,264,1468
4.606760536193839,1.7880698013305576,chief,12922,1421,14343
5.627382553100588,1.534785850524898,chieftain,219,180,399
5.1618743362426756,3.8822763061523418,child,10686,22791,33477
4.84095153045655,0.004017639160153408,choreographer,343,68,411
3.083248367309565,2.610979347228998,chum,50,12,62
4.6776469955444355,1.9733263854980478,churchgoer,12,20,32
4.1054111785888665,1.9223274612426735,citizen,1644,4207,5851
5.959579101562504,3.417966072082514,claimant,322,157,479
-2.056510665893562,2.009938224792478,class,22588,3889,26477
3.789600730895991,2.2104994049072246,classmate,285,358,643
5.625659576416005,2.4126704483032313,client,849,738,1587
5.25658619689942,-1.7069183197021545,climatologist,5,11,16
3.7632717742919937,2.023523796081548,clone,530,430,960
4.223176109313968,0.3300380859375167,closer,3303,30,3333
5.4940539550781295,1.8019921264648389,coder,5,8,13
5.542593078613287,1.4388487091064448,collector,1208,673,1881
4.688616012573242,3.7315162200927645,combatant,110,295,405
5.775120361328121,3.762916961669916,comer,60,26,86
5.484152969360359,0.6912764053344702,commander,11359,1979,13338
5.2033394088745055,-0.3369785614013736,commentator,705,1446,2151
5.155772491455075,2.5097675476074244,commoner,103,226,329
4.919201644897477,-0.17456623077393374,communicator,55,23,78
3.8202752609252926,2.975069686889647,companion,1945,908,2853
4.725804862976084,2.7200919265747103,compatriot,106,120,226
2.4380298385620023,-0.775525329589847,competition,8431,1677,10108
4.166162887573243,4.159212921142576,competitor,670,1164,1834
3.515080940246577,0.5299712982177738,computer,6158,1189,7347
3.9067548522949025,2.4162336807250924,comrade,138,420,558
5.0412629089355505,0.5102133026122999,confessor,201,12,213
4.6515812759399395,0.3697901458740276,confidant,112,27,139
3.6528068542480483,3.459287841796879,congener,28,32,60
4.9442176513671825,1.958678039550783,conquistador,73,91,164
3.7192870483398437,1.178993133544921,conservative,3913,1056,4969
5.144753486633306,-1.3785973281860464,conservator,35,47,82
4.515668289184568,2.2142813644409145,consumer,1085,700,1785
3.0546678009033172,0.6795712356567307,contemporary,7271,1034,8305
5.774311309814458,4.050508956909162,contender,690,440,1130
3.257452293396007,4.312304702758787,contestant,600,631,1231
3.3239637603759817,0.36444153594970885,contractor,517,456,973
4.20574572753906,-0.5185831375122021,controller,1077,450,1527
2.53157695770264,3.076096244812014,coon,178,31,209
2.7627921066284244,1.9761962432861324,copycat,47,4,51
5.74974610900879,0.32530692291258845,correspondent,740,161,901
4.883767616271967,1.1085093154907284,cosmonaut,67,73,140
3.0865698699951167,2.3348049163818345,cottager,4,12,16
3.6402033157348583,-1.0110464019775378,counter,3737,237,3974
5.228412185668944,0.07927724456786223,courier,460,52,512
4.284356986999512,3.6777874755859443,cousin,2123,509,2632
5.438450370788573,0.6061146621704196,coward,412,47,459
4.897053367614745,1.353615104675292,cowboy,511,523,1034
4.138845916748046,1.1222288131713896,crab,499,351,850
3.8110169906615994,1.0479176940917938,crawler,42,21,63
5.997730140686045,-0.024325218200687004,creator,2950,871,3821
3.3925309219360287,0.7979174499511714,creature,1566,1534,3100
4.843825088500964,0.0340965805053699,creditor,49,282,331
3.0340272674560467,-0.17104010009767023,creeper,61,18,79
5.059048995971679,-2.45398448944092,cripple,127,24,151
4.853319496154782,1.1464847183227675,crony,9,21,30
2.170446830749512,1.2942442245483434,crossbreed,15,11,26
4.005564857482902,3.246598976135246,crusader,424,719,1143
-0.21158792114258063,0.8237790145874015,cultist,4,22,26
3.28660787200927,2.148510360717779,cyborg,102,17,119
4.629158042907704,2.592183059692381,dancer,921,1857,2778
3.785983993530273,1.1845141372680672,darling,422,8,430
5.030030105590811,2.7935402832031215,debater,31,12,43
5.114575073242179,0.9357639007568395,debtor,50,156,206
3.2317613143921022,-0.12636566162108664,decoder,16,4,20
4.967097473144534,1.597002494812024,defender,1208,1711,2919
4.214783714294455,1.5016791305541943,deist,23,23,46
4.490377372741698,1.5065460128784238,demigod,56,26,82
5.452580696105954,1.63776414489746,democrat,1048,2107,3155
4.869862838745114,0.009869705200195256,demon,1286,830,2116
4.9287900238037,1.0491968765258761,denier,26,74,100
4.902463584899905,1.6290419082641705,denizen,13,48,61
4.660051139831538,0.8003425445556545,descendant,584,1249,1833
3.9081007537841685,0.9776961822509804,descendent,53,64,117
5.32105715942383,0.6274513244628892,deserter,44,163,207
6.017531570434571,-0.6601596755981447,designer,3003,1167,4170
3.322584754943847,1.68352785491944,destroyer,2451,2839,5290
4.478829902648933,0.09479576110840071,developer,1287,2254,3541
4.625628356933589,2.2706234817504907,devotee,164,289,453
6.06322921752929,0.8878176040649279,dictator,558,69,627
1.6188683929443357,2.4768647308349614,diploid,102,3,105
5.471882705688479,-0.7877261352539051,director,16935,2898,19833
4.984886329650884,1.8443595275878906,disciple,228,397,625
5.806352493286134,1.2678521881103535,discoverer,126,90,216
5.459459495544436,1.0804922790527343,dissenter,42,264,306
4.194973571777332,1.251559005737306,dissident,181,223,404
2.8477940444946412,0.4453190689086952,distributor,538,299,837
5.154546951293945,-0.37278182983398267,diver,402,582,984
3.638338218688986,-0.41499640655516146,divider,38,18,56
5.137344215393064,1.6826418380737351,doer,8,11,19
5.4100083465576105,-0.05280084228515136,doubter,3,20,23
3.1917777862548746,-0.06635870361327534,drawer,85,25,110
5.751725219726559,1.1834895629882851,dreamer,189,102,291
4.896765792846686,1.074183334350593,dresser,116,15,131
5.285759124755856,-0.644994842529286,dribbler,13,3,16
4.745505088806148,2.0250661697387784,driver,3170,2734,5904
4.217102027893063,1.201923492431618,dropout,122,15,137
3.885854782104495,0.6041610336303762,dummy,280,88,368
4.957403785705566,-3.2702404632568474,dupe,16,5,21
5.37067282104492,2.2371462783813385,dwarf,1530,191,1721
5.768608627319331,3.3051770935058613,dweller,49,146,195
5.460489822387693,2.571877372741696,dynast,18,10,28
5.067442909240725,-0.561496398925776,elder,2150,349,2499
4.776533920288081,1.5958700485229542,emcee,24,12,36
4.003437011718731,2.463231536865237,employee,1165,3109,4274
4.769254486083987,-0.6680922927856443,employer,701,562,1263
3.771217796325679,2.35681342315673,emulator,40,12,52
4.571024513244623,2.625108245849617,endorser,28,15,43
2.498488265991213,0.5212613906860426,enemy,7687,3948,11635
2.182775375366198,1.3251187362670862,engine,7650,4212,11862
5.223040290832515,0.36548750305176014,engineer,4249,2635,6884
4.0610742950439445,4.233044883728034,enrollee,3,7,10
6.039995170593258,2.3289711380004903,entertainer,392,198,590
4.932462707519534,4.007532737731914,entrant,130,162,292
2.764926582336429,-0.450007461547834,equal,3697,361,4058
4.099602630615237,0.5844561386108467,estimator,6,6,12
4.709888763427735,4.22897901153565,eukaryote,14,223,237
2.524483802795416,2.7364657745361356,ewe,73,102,175
4.8796188964843665,-1.269364974975602,exchanger,18,24,42
5.5744634552001955,1.2725102386474418,executioner,139,52,191
5.19594523620605,-0.7021341705322257,executor,108,81,189
5.03424407958984,2.806875419616695,experimenter,47,34,81
5.058640480041511,-0.1846040649414178,expert,1548,1285,2833
5.502988471984864,2.208257461547852,explorer,919,491,1410
4.9376839218139565,0.7084021759033163,exponent,147,94,241
5.151688606262205,2.2181682434082077,exterminator,13,10,23
3.861914848327636,-0.1476154785156183,extremist,114,105,219
2.977570869445799,-0.7459610824584857,face,10404,2002,12406
3.751187507629389,-1.3115106201171827,failure,5572,776,6348
-2.7130728225708083,3.597291908264161,family,35185,5277,40462
4.34627213287353,0.9809139862060547,fan,5086,10304,15390
5.724476966857921,2.314577842712403,farmer,1513,1784,3297
3.13495414733886,-0.08248271942137819,fastener,9,12,21
-0.4878758468627922,1.8732844314575345,fauna,657,37,694
3.7578388671874947,1.9559821090698222,favorite,3764,451,4215
3.978093444824232,0.7899830398559544,federalist,332,206,538
5.138231742858892,2.3790019378661924,fella,49,20,69
2.798397499084473,1.8100027008056614,fellow,6041,492,6533
4.966361618041994,1.2348705749511808,fencer,41,8,49
3.1953925552368077,1.7190077590942394,feudatory,42,29,71
4.540118980407726,1.5225640182495113,fiddler,69,31,100
4.928752471923829,2.6688796539306665,fighter,5058,3343,8401
4.230857131958011,1.2863175201416013,figure,7057,6255,13312
5.331866645812987,0.46380955505370025,financier,159,84,243
5.203453590393053,-0.7125357131957983,finder,123,40,163
4.0776361618042145,3.625318679809574,finisher,218,162,380
2.7153369064331017,-1.2691410598754942,flake,50,80,130
4.3512516784668165,1.2899271926879976,flatmate,20,10,30
4.9424502868652525,0.9817088088989294,flier,38,84,122
0.925837455749523,0.720112365722656,flora,883,18,901
3.7868906097412136,1.4545757064819327,flyer,226,597,823
4.99315190124512,1.5976501083373975,foe,270,292,562
4.532270118713377,1.6982059402465808,follower,240,1792,2032
5.228429512023922,0.4060561370849598,fool,558,220,778
6.312904838562012,1.245623580932616,foreigner,132,542,674
2.9542603836059627,2.0900703048706077,forerunner,415,132,547
4.367717811584477,2.601177497863766,fox,8099,510,8609
5.598724365234368,0.291921035766606,freelancer,63,18,81
5.23128885650636,1.3896001892089913,freethinker,15,5,20
5.249550529479976,1.0519324874877896,friend,9824,10015,19839
3.98123468780517,2.1025215530395513,fucker,9,5,14
5.662109336853028,2.7760106353759824,fugitive,346,141,487
3.7048738632202216,0.6660258331298934,fuller,916,7,923
5.91092736816406,1.1321390228271468,gambler,183,79,262
5.267658172607419,-0.4121548385620031,gatekeeper,94,14,108
4.83065836334228,3.5531153717041093,gatherer,53,118,171
2.662396949768066,1.0420161056518538,gay,4156,174,4330
4.770365760803216,1.596278259277355,geek,285,60,345
5.111233062744134,-0.38313757324219466,genealogist,41,16,57
4.389218162536615,2.0842889251708954,genius,1206,75,1281
3.890208930969237,0.5809308624267473,gentile,57,24,81
5.068852508544914,-0.15198369598388695,geographer,144,30,174
5.263091140747065,-0.4731263198852531,geologist,232,183,415
4.7836144332885695,3.3772983093261786,giant,4076,3129,7205
5.2661061096191375,1.0551663131713909,giver,51,9,60
3.9128035659790186,1.8070503311157111,gladiator,221,137,358
3.2867151718139596,0.7976717376708891,goat,456,327,783
5.2858759002685645,0.6052224502563632,goon,52,38,90
2.825408187866209,2.2519652252197133,great,31055,109,31164
4.924463027954097,3.588452377319335,grownup,5,8,13
2.9243755264282214,-1.0697174301147498,grunt,86,103,189
4.820807044982907,0.0582230377197277,guardian,3158,442,3600
3.6591902694702156,1.4535899734497022,guerilla,100,42,142
3.9197891921997154,1.3557221221923825,guerrilla,627,350,977
4.788480094909659,-0.25268604278564766,guide,4317,735,5052
4.995559242248532,1.5159487991333052,gull,180,169,349
5.432163681030282,0.5804628829956044,guru,332,97,429
3.1630084152221585,-0.24503764343261025,gutter,56,40,96
4.782607841491711,1.15445438385008,hacker,216,83,299
3.246705642700192,-0.2741791534423754,hanger,51,35,86
5.039005065917969,0.7286669616699228,hater,31,58,89
4.681178833007813,1.1003418197631945,head,21431,4830,26261
5.428643203735348,-0.11776640319825304,healer,107,29,136
4.086380630493174,1.9813448486328156,hearer,7,14,21
4.017534225463869,1.0900673904418952,heathen,173,82,255
3.078598709106444,2.679380279541,heavyweight,1820,25,1845
5.094112861633299,1.0574841384887748,hedonist,6,5,11
4.426375534057605,0.9376998443603597,helper,298,120,418
2.426569686889657,1.847058876037579,heterosexual,280,24,304
4.585887039184584,1.188933776855464,hobbyist,20,52,72
5.4256696472168,1.4290449523925801,holder,707,609,1316
4.083286132812496,1.515643074035637,holidaymaker,3,14,17
4.593886886596678,2.008926567077637,homeowner,26,74,100
3.4252099075317304,1.7932742996215794,homosexual,727,287,1014
2.4729059753417957,1.2703554382324214,honey,1016,3,1019
3.4553332748413084,3.4411245498657266,hopeful,260,26,286
5.369132629394542,-0.2845760650634759,horticulturist,23,10,33
5.459780029296873,-0.1531806335449204,host,4855,2168,7023
5.062928787231442,2.4378138885498046,householder,118,43,161
3.1476808624267676,-2.0164169311523423,hugger,10,3,13
2.957987571716309,2.0864088058471424,hulk,695,25,720
4.299186462402346,0.7662792587280265,humanist,232,24,256
4.2257653884887745,1.3445447616577226,humanitarian,705,6,711
5.136639640808113,0.3180553054809536,humorist,48,13,61
3.886497436523399,2.110179847717305,humpback,115,33,148
5.808594383239743,1.5031205749511827,hunter,2405,1345,3750
2.971880104064944,0.3299758148193348,hybrid,1404,491,1895
5.219153045654288,1.471205421447749,idealist,44,23,67
4.948164718627929,0.36296636962890716,ideologue,38,15,53
4.927873268127435,0.841943183898934,idiot,257,75,332
3.7844126358032213,2.1826699981689544,idler,24,11,35
5.044694755554204,-0.39110800933838163,illusionist,29,4,33
4.01352799987793,3.6731396331786925,imitator,19,68,87
4.0265913009643555,0.3987170715332127,incarnation,560,200,760
4.030013954162598,0.582113586425784,incompetent,247,7,254
3.562531227111826,1.7939741973877048,independent,9332,204,9536
2.8305967407226476,2.0392746353149533,individual,9095,5814,14909
4.515392845153805,0.9471420211791965,individualist,68,4,72
3.0754607009887707,1.1743550338745052,inferior,883,10,893
4.8530658035278265,0.7009133682250948,infidel,39,28,67
5.430157127380369,-0.2898334503173814,informant,197,95,292
4.868213798522945,3.3298017044067265,inhabitant,80,2425,2505
2.7143677520751908,-1.8798283004760776,initiate,520,183,703
4.84640512084961,0.9191516265869097,initiator,70,38,108
5.119210723876954,0.7220313949584849,instigator,68,30,98
3.8484448852538975,1.323567314147958,insurgent,136,505,641
3.4213807144165145,1.3815777587890565,intellectual,1618,375,1993
5.202564163208002,1.937673858642576,interloper,11,7,18
4.388567481994627,1.8742946624755845,internationalist,102,10,112
4.422236366271967,0.18518244171142584,interpreter,309,104,413
3.1351691436767553,-1.2041330337524414,intimate,942,26,968
5.568102355957031,0.5630078811645589,intruder,170,146,316
5.593790832519538,0.3435149841308558,inventor,450,97,547
5.782382232666009,-0.17733688354492472,investigator,315,689,1004
4.874233161926277,1.2021786270141632,investor,282,966,1248
2.9507365493774387,1.82995296478272,irregular,954,99,1053
5.125659057617206,2.484346229553232,islander,205,587,792
4.546306930541995,1.6821207275390577,isolationist,54,7,61
5.58965815734863,-0.8823273925781194,judge,4872,1916,6788
5.603794570922858,2.757138809204122,jumper,233,105,338
3.482852668762199,3.0632470397949234,junior,4573,210,4783
5.527165748596197,-0.365695167541503,jurist,112,80,192
4.39965215301514,3.0298327713012654,juvenile,1216,771,1987
5.4589934082031135,3.5935825347900447,kid,1678,2277,3955
5.567751701354972,1.0211751861572296,kidnapper,51,73,124
4.854423965454096,1.6760264434814474,killer,2162,363,2525
3.0359794998168894,-0.1062575454711876,knocker,19,6,25
3.396122512817385,2.481491912841797,lamb,1003,205,1208
5.520024383544914,1.4471874313354505,lawgiver,12,9,21
5.63782666015625,-0.0026134719848727173,lawmaker,21,116,137
4.7101236267089845,1.2038428497314442,layperson,11,16,27
5.200257774353027,1.3922086563110483,leader,10593,6269,16862
5.069900993347176,3.167667289733899,learner,34,55,89
3.975574234008789,0.8289167327880875,leech,216,48,264
3.696988876342772,2.300631271362306,lefty,76,18,94
3.597923011779784,1.4530461196899438,liberal,3578,829,4407
3.856448204040518,1.3483861007690479,libertarian,345,44,389
4.011887283325201,0.0257122116088766,libertine,40,25,65
4.939407417297367,-1.3918990783691356,linguist,135,122,257
4.09507424163818,2.419727912902843,lion,2318,1555,3873
5.329614334106438,-0.1258418655395488,liquidator,14,3,17
3.508857704162601,1.7016000137329144,listener,493,910,1403
5.387860565185548,2.2168382720947193,litigant,8,34,42
5.215889228820799,0.9722920532226595,logician,9,8,17
5.105664352416994,1.220393051147461,logistician,3,4,7
5.49253298187255,1.0214120788574235,loner,89,9,98
5.905132064819334,1.274352958679195,looker,7,4,11
4.641689155578611,2.6101443710327104,loser,332,101,433
2.5787170944213926,0.5793966293335018,lot,6579,982,7561
5.217176879882821,1.4663008346557547,lout,5,4,9
3.6318761062622045,3.5572607574462936,lover,1724,878,2602
4.823448585510249,0.894076385498046,lunatic,154,37,191
2.3476843719482403,0.9020342712402325,machine,7173,1647,8820
5.00664458465576,0.7690729293823324,magician,286,100,386
3.0657955245971635,2.5703229217529255,mailer,32,4,36
5.385748710632313,-0.47362295532226284,maker,998,646,1644
4.964633354187015,-0.08944857025146291,manipulator,53,15,68
4.549133888244626,3.2485011062622107,marcher,83,105,188
4.923505065917965,0.937928535461424,mascot,689,140,829
5.837933830261228,0.06625205230714215,master,6147,1962,8109
4.9635499725341745,-0.27752308654784485,mastermind,125,23,148
4.300026100158696,1.2934682846069308,matador,71,9,80
3.787795097351079,3.2410531539917002,mate,1933,788,2721
4.160207580566407,0.02461289215087703,materialist,37,3,40
4.386258689880371,0.8291704101562516,mathematician,445,244,689
5.034624450683587,1.2878424301147504,mentor,879,86,965
4.473511695861816,1.0191313400268456,mercenary,329,507,836
4.665407173156737,0.31298144531251637,messenger,644,245,889
5.177071197509768,0.08648155212402742,metallurgist,17,22,39
1.5360693206787133,0.20186575317383415,microorganism,17,150,167
3.4062003631591793,2.4375408782959056,midget,221,25,246
4.488017059326175,1.873258338928217,migrant,271,387,658
4.375993957519533,0.61221261596679,militarist,16,11,27
3.3881889877319367,-0.04992520904541209,millenarian,20,3,23
5.671133941650389,2.240528495788581,millionaire,439,101,540
5.169207267761237,1.1842333145141524,mineralogist,26,3,29
4.016975631713869,1.418702880859378,minor,9647,325,9972
3.4993410644531338,1.7623787460327378,misfit,45,68,113
5.393952453613281,1.2061924438476552,missionary,872,796,1668
3.229576622009276,0.9909759597778276,model,8931,4412,13343
4.688892196655289,0.399149681091302,modeler,7,14,21
2.7102814407348603,-0.18028465270996463,moderationist,3,7,10
4.225173164367675,0.3234306259155346,modifier,12,23,35
5.724267768859853,1.5774645996093852,mogul,81,44,125
3.5802204132080107,2.3973714218139577,moneymaker,14,4,18
3.211059989929197,2.540416107177741,monolingual,23,3,26
4.501379081726071,0.22843617248535253,monster,2710,1545,4255
5.461586196899418,0.8227478179931751,moron,20,10,30
4.389842041015619,1.003097259521482,mortal,1050,66,1116
5.69709589385986,3.0545699234008836,motorcyclist,24,20,44
5.421907287597662,1.6877540054321258,mountaineer,132,278,410
4.76402251434326,1.712843025207519,mourner,29,268,297
3.970153228759763,0.9847915649414105,mouse,1447,563,2010
4.707492248535161,0.9099549713134749,mover,97,45,142
4.492108665466304,1.5414923248291004,murderer,536,180,716
5.473980384826653,3.101595207214352,musher,18,66,84
3.785542800903322,0.7788062438964829,mutant,417,209,626
4.09015867614746,-2.09176832580566,mute,191,17,208
5.751937683105467,0.1657613220214813,namesake,443,19,462
1.7265033874511744,2.718698150634765,national,45586,624,46210
3.8738765640258848,0.700270553588858,nationalist,1439,581,2020
1.9374535903930763,2.589275100708008,native,8244,910,9154
3.056832168579099,0.5700858459472542,natural,10166,82,10248
2.248858016967773,0.027711784362786318,naturist,4,3,7
5.069445182800294,1.0920946960449243,navigator,307,77,384
4.035016174316411,-1.7697946243286111,nazi,2747,791,3538
5.314036888122558,0.2645577621460049,negotiator,111,89,200
4.5241454467773465,1.2107006759643397,neighbor,651,678,1329
4.16576810455323,1.5746379852294865,neighbour,306,980,1286
4.588456054687498,1.3869708709716804,nerd,79,51,130
4.389485176086438,3.4085280685424806,nestling,69,203,272
5.153450042724607,0.3282752304077192,nigga,33,48,81
4.97666593170166,1.2026376342773446,nihilist,16,7,23
1.8879249267578118,2.3252733840942383,nobody,1284,26,1310
3.2878667602538982,1.6441757278442424,nonconformist,69,24,93
5.0327945175170825,1.9433866882324295,novice,133,38,171
2.9568504714965798,2.1992358474731546,nudist,11,3,14
5.151670555114748,-0.13783448791505748,numismatist,103,48,151
6.276047546386721,0.7309264068603554,oaf,8,3,11
5.245725296020495,2.6671731185913075,objector,28,44,72
4.6999725875854494,0.03973128509521473,observer,1706,1213,2919
3.3768788223266597,-2.653478248596187,occult,282,4,286
5.219813148498545,1.0544263763427608,occultist,64,28,92
5.038720169067389,2.717752784729001,occupant,124,439,563
4.918657257080085,0.2411316986083989,occupier,57,94,151
5.131364852905264,-1.2657458343505965,oceanographer,26,7,33
4.296798500061044,0.5127632293701083,oddball,39,4,43
5.5656519012451255,2.2146253662109388,offender,149,200,349
4.256200233459474,-1.3054966583251968,official,14224,7271,21495
-0.8831407699584943,2.7885601196289045,offspring,959,8,967
4.0288445739746095,0.5234494400024516,oiler,77,513,590
4.958029541015627,2.5667407302856446,opener,915,145,1060
5.081616806030269,0.1657300491333018,operator,1272,950,2222
4.337483528137213,1.5706949081420944,opponent,2661,3149,5810
2.6363375778198233,0.3345676651000957,opposite,3650,104,3754
1.830371124267586,-0.6530247802734266,opposition,5996,33,6029
1.1343829727172903,2.50915805053711,organism,612,1676,2288
5.283749572753905,0.7943828735351559,originator,73,32,105
5.368328758239748,3.237706352233886,orphan,293,228,521
2.3929967193603545,3.3923987121582044,ostrich,104,34,138
4.027139244079592,2.196042640686038,outcast,132,115,247
5.044922050476075,2.494794029235841,outdoorsman,13,4,17
5.021627098083499,1.467352989196776,outsider,288,219,507
5.424073806762699,0.8878270950317386,overlord,411,94,505
5.631428245544434,-0.2974436721801794,owner,4043,3208,7251
4.785318557739259,1.8439474716186623,pacifist,131,31,162
2.90343989562988,0.8204877014160132,pagan,1001,113,1114
5.187400291442863,2.0718279953002963,pal,393,79,472
5.025452247619633,-0.406328727722169,palaeontologist,89,45,134
5.569703575134284,0.2328460159301784,paleontologist,237,212,449
3.5133587417602428,0.37353580474852777,pansy,16,4,20
5.253012466430668,3.0687918930053684,parachutist,10,35,45
4.165818733215339,0.23993458557129088,paraplegic,61,5,66
3.1808354263305674,-0.5303772888183573,parasite,480,689,1169
3.5733581161499046,3.1014183959960917,parent,1965,7259,9224
4.15021386718751,1.4716750259399447,pariah,37,4,41
5.246803939819344,1.27010969543457,parliamentarian,225,228,453
2.6759431076049864,1.6701801834106433,parrot,485,274,759
4.71808937072754,4.5178809967041005,participant,503,1763,2266
3.9426056900024378,-0.6758395538330149,partisan,1034,924,1958
3.2690902938842683,3.225822441101073,partner,3356,1725,5081
-2.1247920608520445,4.549716758728017,party,26195,4288,30483
5.307155807495128,-0.6085618057250883,pasha,580,8,588
3.9562116165161143,2.738397651672365,passenger,3612,3795,7407
4.8624498443603414,-0.11356391906737429,passer,272,66,338
3.691070976257322,0.678785217285153,pathfinder,69,45,114
4.144647361755368,2.0920896301269565,patient,1587,2039,3626
4.671036964416508,2.1363489761352454,patrician,91,102,193
5.586787483215332,1.4722900314331042,patriot,574,635,1209
4.503653816223121,0.8935509567260738,payer,32,28,60
3.364076385498045,2.291891036987309,pedestrian,581,236,817
4.012833435058589,1.6737109375000045,peer,556,986,1542
5.831457214355474,2.6379860153198322,perfectionist,145,9,154
4.888900573730467,3.1189133605957053,performer,1139,1440,2579
3.5886277389526313,1.984541252136239,person,11675,49224,60899
5.040461860656734,2.1410750427246086,personage,31,38,69
3.799873687744146,0.24828353881836307,personification,141,32,173
3.2956230926513683,1.0230405273437455,pet,980,387,1367
5.592943572998053,2.554071372985838,petitioner,56,66,122
5.077565399169913,1.9028960494995104,philistine,31,30,61
5.043686981201155,0.8403728637695238,philosopher,1071,527,1598
5.374240982055667,0.554806213378896,physicist,630,364,994
4.233320945739749,2.139047882080078,picker,36,35,71
4.804194992065426,0.9264497146606558,pitcher,1788,547,2335
2.6925083694457967,2.860763397216793,planet,6078,2394,8472
5.041406753540038,-1.556196685791015,planner,153,377,530
1.7571645202636716,1.2154147644043007,plant,7415,5599,13014
5.782722137451174,1.6017590637206993,planter,112,105,217
4.498414909362786,0.9544478073120075,plantsman,4,7,11
2.229225334167481,4.015028312683107,player,27922,20973,48895
3.7300735626220813,0.6523334045410181,pleaser,25,3,28
3.831572166442868,1.297513679504398,plebeian,172,114,286
5.290831100463876,0.5086923599243249,plotter,27,166,193
5.2203500137329115,0.3337725830078142,poisoner,18,7,25
5.663923248291027,0.6446941452026422,politician,1622,1734,3356
3.0047201309204183,1.5933914413452186,polymorph,13,7,20
2.100515106201172,2.8195198669433523,polyploid,10,7,17
3.8263722686767565,0.709607971191403,populist,280,44,324
3.9761356582641696,1.5487416534423843,positivist,36,15,51
5.257522720336922,2.1048599929809626,possessor,44,12,56
4.032505928039562,-0.21891548156738594,poster,893,675,1568
5.404025985717773,0.5864253692626917,potentate,5,13,18
3.794137870788582,1.7750349426269452,powerhouse,224,22,246
5.312209548950186,1.3829104766845717,pragmatist,16,11,27
3.1445979080200246,-0.7992895202636703,prayer,1689,515,2204
3.413793762207014,1.3042707672119107,precursor,807,238,1045
3.741015098571779,2.77626219177246,predecessor,2358,1121,3479
5.6145108566284065,0.897872100830071,presenter,374,82,456
4.906962715148936,-0.8346283874511755,preserver,23,8,31
4.2469867935180545,3.233094902038573,preteen,22,4,26
2.4167930450439457,2.085642509460449,primitive,1094,31,1125
4.792318397521974,2.83840123748778,prisoner,2082,4335,6417
4.297206680297855,1.2098607788086042,processor,369,188,557
4.863814910888664,-1.0576709823608397,producer,10663,5972,16635
3.83128957366943,1.51947579193115,professional,9659,775,10434
5.43675700378418,-0.42100032806396825,profiteer,4,8,12
5.113803565979005,1.6892341537475488,programmer,376,275,651
3.369081932067864,1.1794246063232308,progressive,1974,66,2040
1.2459757995605472,2.7308139648437475,prokaryote,8,103,111
4.865969093322754,-0.20577189636232163,propagandist,62,27,89
2.6713538665771424,1.032635017395009,propagator,4,8,12
4.859622756958004,0.590287559509278,prophet,560,211,771
4.946479965209967,-0.5696739425659274,proponent,358,467,825
4.221316360473622,0.6428884963989248,prospect,1495,695,2190
5.450302886962895,3.5718752517700096,protagonist,2821,726,3547
3.9230397415161207,-0.7237883529663094,protectionist,83,16,99
5.893623008728028,0.1445914459228561,protector,494,89,583
4.672328804016118,1.6841286163329983,protester,79,834,913
4.5257919464111325,-0.03572537994384106,psychic,426,13,439
4.792020782470701,-0.832078918457043,publicist,216,26,242
5.655259254455565,1.2246462860107385,pugilist,10,9,19
5.604050155639655,0.8015912704467922,puller,70,5,75
5.707104507446303,0.6716702270507824,punter,140,15,155
4.35518255615235,2.1642976608276427,pupil,643,1177,1820
3.221428398132325,1.6540461502075203,puppet,757,391,1148
5.830899040222171,2.881293830871577,pursuer,34,129,163
4.468011848449699,2.94902271270751,pussycat,98,10,108
2.8972092056274406,2.286361907958984,pygmy,309,12,321
4.7131956558227515,1.5202840957641683,qualifier,295,178,473
4.4122420425415,0.5163658599853633,radical,2099,337,2436
2.6911607818603542,-0.5960689239501988,rafter,39,110,149
4.5727867584228505,0.13383059692381494,ram,1117,524,1641
5.37396356964112,2.981730346679697,rambler,46,31,77
3.4213636245727557,0.969272827148437,rat,917,913,1830
4.656517547607422,0.13167017364501987,rationalist,56,5,61
3.4309765777587984,3.423304328918455,raver,26,3,29
3.0981269912719753,1.911385040283193,reader,1645,2530,4175
4.973041076660159,1.4256277465820304,realist,175,20,195
5.453046676635729,-0.8542157440185605,receiver,1075,346,1421
5.6384715805053744,3.282202224731442,recipient,942,539,1481
2.7932278594970654,-1.047190612792967,recombinant,53,3,56
2.9302413482666054,0.41795478820799303,rectifier,19,24,43
3.858769348144527,-0.46075883483887026,recusant,19,29,48
3.9932043991088833,-0.9045375595092651,referral,69,12,81
5.439117744445795,0.9371816482543949,reformer,262,373,635
3.751641693115232,0.3834500579834028,reformist,152,26,178
5.512406623840327,0.3576313934326123,regent,858,329,1187
4.61099019622803,4.0326581954956,registrant,22,13,35
2.5246423568725618,2.5546332855224634,regular,10127,541,10668
2.2481077957153346,0.9263974456787096,relative,3500,1927,5427
2.13202212524412,1.1266396255493163,relict,45,6,51
5.218174591064447,0.4888287277221721,reliever,130,38,168
4.655760665893567,1.9283417282104622,renegade,168,60,228
4.192486099243155,0.0030729827880975336,repeater,23,24,47
3.468053771972656,1.485337127685547,replacement,3695,469,4164
5.099023292541503,0.33193664550781676,reporter,2158,960,3118
4.372230094909668,0.6514544067382886,representative,3604,3665,7269
2.311302726745609,0.789585807800286,republican,5703,1900,7603
5.276010772705078,0.05407987213135357,rescuer,35,129,164
4.864824317932133,-0.7072593841552717,researcher,573,2025,2598
3.802663124084468,2.707550247192394,resident,2894,6817,9711
4.90124147033692,1.5798287200927774,resister,7,31,38
5.680935035705566,2.665755378723148,respondent,74,285,359
4.987684974670415,1.0777106094360391,responder,19,53,72
4.347085945129386,1.4724928359985299,retainer,72,113,185
2.7108233413696183,-2.822434516906739,retard,29,9,38
5.501172492980956,2.883770401000973,retiree,6,30,36
4.028391532897949,-1.4387740783691356,revenant,77,17,94
3.9993690032958966,3.349756057739256,revolutionary,3007,415,3422
5.028518943786608,1.0139014434814513,revolutionist,13,9,22
4.507027969360344,3.2555987777709845,rider,1748,2746,4494
5.073135536193853,0.7533056488037175,ringer,61,34,95
2.563336990356447,0.49924416351318257,riser,34,15,49
1.3848904190063536,3.006098976135249,rival,3393,1796,5189
2.980876663208008,-0.36899925994872973,rock,20733,2453,23186
5.358639579772934,0.8579571609497094,romanticist,20,4,24
4.234498023986816,1.7593989181518666,roommate,220,69,289
6.134706024169915,4.156220504760739,rounder,239,35,274
3.4587870712280164,1.7377240829467695,rover,243,1019,1262
5.691614807128907,1.6719919586181646,ruler,2020,1278,3298
3.9697256469726483,3.093217575073247,runaway,369,62,431
5.39489910125733,2.9795418701171954,runner,1782,1214,2996
4.187946266174315,0.8080738754272545,runt,25,3,28
4.806512298583982,3.4256005477905234,rusher,124,44,168
4.849146591186525,0.6074426345825188,sacrificer,4,3,7
5.890600425720216,2.105469230651849,saint,7507,1553,9060
4.764018585205079,0.8526480712890603,salvager,4,6,10
5.423126434326171,2.3044024810790944,salvor,4,7,11
2.645557762145998,2.7236810760498003,samurai,255,4,259
3.697244125366211,1.795132369995109,satellite,2778,536,3314
3.615271949768072,1.4684216995239225,savage,1243,89,1332
4.732249916076654,0.2798349685669024,saver,22,14,36
4.851119064331051,1.3066046524047934,savior,197,18,215
3.412159416198726,-1.053821891784679,scab,14,15,29
2.3729023971557694,0.9468389434814455,scalawag,4,10,14
5.097356063842767,1.706008789062487,schemer,14,4,18
5.161294105529798,0.06571369934082583,scholar,2260,3394,5654
4.29866104125977,2.1266431732177864,schoolfriend,14,4,18
4.486327415466299,2.552017173767098,schoolmate,43,54,97
5.169544219970696,0.36279537963867625,scientist,1552,3121,4673
3.288486274719247,2.3924023208618195,scorpion,175,121,296
5.8579056320190475,1.0798956451416046,scoundrel,25,35,60
3.065061187744142,-2.406808311462406,scourge,62,5,67
4.547753166198731,-0.5408737869262694,scout,1937,1222,3159
5.565664749145498,1.9183326339721631,screamer,6,13,19
3.0562017364502054,0.14464015197754065,scrubber,7,7,14
5.210796730041494,1.7224713439941297,searcher,25,49,74
3.2260051651000907,1.5060439682006859,secessionist,90,29,119
2.7008180236816415,1.1527695999145493,secular,1092,3,1095
3.80628395843506,0.803096298217767,secularist,9,7,16
5.035965950012198,2.04106754302979,seeker,96,196,292
4.628365974426266,-0.8295045852661147,seer,72,13,85
5.5933498687744105,-2.651545166015623,selector,111,417,528
5.214420730590817,2.0309159927368086,sender,40,11,51
4.534865386962892,2.8762636718749945,senior,6947,291,7238
3.764598320007323,1.3480116500854464,separatist,154,73,227
4.348136001586909,2.2599592208862376,servant,932,1108,2040
4.750393615722665,-0.17825957489012012,shaker,89,36,125
4.2183712692260755,1.617478950500498,shark,3428,2071,5499
5.088375434875488,2.4315007781982416,shipowner,12,17,29
5.405147079467774,2.4549192047118993,shooter,949,311,1260
0.8265578613281122,1.3817073440551795,shrimp,352,67,419
-0.17976719665526275,4.9850016098022465,sibling,242,1035,1277
4.129655395507811,2.929144691467293,sidekick,199,33,232
5.027148963928212,0.4243674392700285,signaller,15,43,58
4.319016632080086,3.2480210418701176,signatory,107,183,290
5.003121940612786,2.952354766845694,signer,38,121,159
3.7892974777221653,2.5500310592651303,sissy,18,3,21
5.187596168518063,2.9589898300170887,sitter,144,33,177
5.3351294555663955,-0.5831012496948205,skeptic,108,102,210
3.187886894226075,2.7157832031249995,slave,2202,2469,4671
2.9942457580566284,2.0773490295410255,sleeper,244,101,345
3.3121601333618145,1.8648237075805696,slider,124,28,152
5.15767643737793,1.6875592041015608,slinger,8,12,20
5.301300727844229,0.3701516952514652,smith,11915,209,12124
3.5076335372924845,0.5809819793701152,snake,1742,725,2467
5.791013214111324,1.311499397277828,snatcher,22,40,62
5.049573493957524,2.780633293151851,snowboarder,20,10,30
5.493538124084473,-0.3928703155517468,sorcerer,270,50,320
3.5485197372436517,-0.24172933197021962,source,8045,6796,14841
5.332064529418936,2.54326084136963,southpaw,21,3,24
5.46808895111085,1.9843505554199226,sovereign,1265,128,1393
3.9822936019897597,-1.714744911193847,spade,86,65,151
3.7298138198852513,1.4827705154418993,spearhead,131,42,173
5.262587295532214,-0.8271797943115118,specialist,1207,385,1592
2.8375635604858402,0.41185326385497945,specifier,3,5,8
4.237123313903808,1.5024817962646466,spectator,442,1348,1790
5.279597824096683,0.6401749038696352,speculator,54,105,159
3.7431582412719706,1.9370470504760746,sphinx,61,8,69
3.5201238555908247,0.2732055053710951,splitter,45,13,58
4.40590758514405,-0.4479642562866104,spoiler,78,67,145
4.342734489440936,0.8693662872314505,spokesperson,608,19,627
2.75162809753418,1.2815822372436543,sponge,263,274,537
2.5515034713745166,1.591735061645501,sponsor,723,507,1230
2.028012077331539,-0.7531732330322143,sport,3920,7486,11406
5.003272979736323,-0.11415977478027628,spotter,78,53,131
2.3217684478759963,3.3693779144287106,spouse,154,127,281
4.039612197875968,0.8372503204345776,stakeholder,14,78,92
3.2747550811767567,1.6916205215454099,star,22042,11432,33474
6.089142333984377,2.2758375473022525,starter,928,237,1165
5.359894615173346,-2.2733540496826166,steward,350,201,551
4.227033958435065,0.29753374481201433,stooge,15,110,125
5.911287704467782,2.261808113098141,stranger,707,303,1010
5.346788017272942,-0.05515993499756178,strategist,116,46,162
2.6891349716186497,1.5957942733764625,strikebreaker,3,27,30
5.613452499389645,2.5277842254638614,striker,1037,273,1310
4.978783432006821,1.6955218429565377,stringer,86,22,108
4.048985626220706,0.570587417602539,stripper,146,102,248
3.96404146575928,2.698598190307621,student,7009,11675,18684
5.029090538024896,3.684948394775404,subject,8316,2649,10965
4.220507141113281,-1.9483257064819242,substitute,1824,209,2033
3.2217454452514716,0.6484110031127983,subversive,235,16,251
4.300040176391597,2.0571727218627913,successor,3119,590,3709
4.728009437561035,1.1504636306762706,sucker,150,71,221
5.319494865417489,2.861743347167966,sufferer,47,77,124
3.399572029113756,2.1862555236816377,suffragist,43,45,88
5.719410957336422,0.12264594268798135,sultan,1768,71,1839
3.933715209960937,-1.2421462936401397,superior,3078,408,3486
3.4638044967651354,1.7640881729125866,supernumerary,38,8,46
5.334640075683595,3.6652595367431644,superstar,488,287,775
5.2115917587280265,0.8010876312255988,supplicant,7,7,14
4.109818267822256,0.6378754959106416,supporter,1286,4151,5437
4.612215164184562,0.542891914367658,suppressor,39,11,50
3.7196186523437547,1.0150892333984416,supremacist,57,19,76
4.998689178466805,-0.3679891128539907,surveyor,413,111,524
5.024188346862793,2.10571878051757,survivalist,5,4,9
4.773398277282723,2.6358035278320315,survivor,1246,2755,4001
5.609854125976554,1.1540159759521487,suspect,1121,795,1916
2.7639670410156256,-0.3437564849853487,sweater,156,45,201
2.221799049377445,3.7107315979003914,sweetheart,241,36,277
5.126476501464843,1.8769718399047974,swimmer,508,319,827
5.302466796874995,-0.4253780975341783,sympathizer,60,168,228
3.1743765869140788,1.350462547302243,syndicalist,55,22,77
5.271033386230471,0.04986769104004196,tactician,53,17,70
5.260695701599126,1.2087354888916053,tapper,29,4,33
3.5155895919799818,-3.419011856079109,tease,115,55,170
3.597663055419922,-1.0555901870727524,teaser,488,43,531
5.087325874328613,0.20604836273193428,technician,275,319,594
5.243371208190922,0.8441369781494217,technocrat,5,8,13
5.103547180175767,0.2814386444091781,technologist,12,8,20
4.997313873291013,3.2424326858520516,teen,1277,435,1712
5.611892181396485,3.8109447937011893,teenager,893,666,1559
5.028139831542973,2.0612513351440427,teetotaler,24,4,28
2.4683809432983495,-2.6035227279663147,terror,1019,48,1067
4.665499824523927,0.6440538406372056,terrorist,911,385,1296
5.1801094131469725,-0.1840567703247089,theoretician,27,8,35
5.3164107437133765,0.0923442382812425,theorist,250,270,520
4.767647529602051,-1.5693532638549854,therapist,159,61,220
5.046473983764649,1.8501151123046853,thinker,129,202,331
3.9981333923339832,3.5096410369873183,thoroughbred,319,119,438
5.28863126373291,2.135653205871577,thrower,72,163,235
5.0745847854614325,2.750358680725107,tiger,1842,1700,3542
3.2663274383544945,-0.8272510910034185,tinker,300,11,311
2.342498908996582,0.45896352386473893,tool,1291,1731,3022
5.042411087036143,0.41587712097167895,topper,138,24,162
5.078799835205089,2.2611257553100472,torchbearer,9,6,15
4.340062309265136,2.3682162475585926,tourist,1593,1453,3046
4.841110214233396,-1.4883378143310537,trainer,694,326,1020
4.401977745056151,-1.8515766754150391,transfer,4003,437,4440
4.953340873718261,-0.2181790847778231,translator,340,110,450
3.1136211242675813,0.17496055603027116,transmitter,237,115,352
3.20817063903808,1.559597541809076,transsexual,67,12,79
4.11837463378906,1.013028686523441,transvestite,33,14,47
5.609218124389642,2.889189254760744,traveler,264,565,829
5.8924958038330075,3.011082237243663,traveller,338,296,634
5.010239990234375,-0.9905437698364139,treasurer,664,19,683
5.10356169891358,1.0639093627929697,trespasser,14,35,49
5.264861175537092,-0.9423213729858446,trimmer,191,23,214
5.336871658325201,0.7335869369506867,troublemaker,49,21,70
5.281630104064945,-1.9186632461547788,trustee,438,1088,1526
4.653890304565429,1.2656882934570248,turncoat,14,5,19
5.447610252380379,0.8153326034545785,turner,2043,10,2053
0.7520537261962872,3.6713845825195293,twin,3171,1065,4236
5.4902344894409225,0.5132136611938449,tyrant,321,108,429
3.9403854904174693,1.562711555480952,unbeliever,11,27,38
4.389381370544427,1.1160340576171848,unionist,175,134,309
4.297325912475586,2.166129959106435,user,1624,2111,3735
5.320533294677745,2.0841261749267517,vacationer,3,18,21
4.224071624755858,1.6621488342285176,vassal,359,179,538
5.069442558288564,1.8524351577758864,veteran,1797,1772,3569
4.228982017517083,3.7167786941528362,victim,1791,3195,4986
5.525446281433105,3.342572280883772,victor,2341,166,2507
2.7675367660522454,1.713028358459475,viewer,1001,7379,8380
5.2141805953979485,1.4164277038574298,villager,61,671,732
5.5038901214599605,1.4815664672851554,villain,1466,866,2332
3.8105068359375025,2.5009759216308467,virgin,2202,77,2279
5.063653709411632,1.9818128585815487,virtuoso,179,9,188
5.003673461914062,1.786586036682131,visionary,215,11,226
5.055257171630863,1.578274520874018,visitor,1018,3227,4245
3.987848907470685,0.9437603836059623,volunteer,1614,2063,3677
5.107089729309067,1.9321392288207946,voyager,815,13,828
5.210909683227534,0.1758012924194361,waiter,176,51,227
5.299279861450195,2.607279113769536,walker,2773,235,3008
5.169879898071294,2.7308454666137862,wanderer,101,815,916
3.8937707443237244,1.7466633453369127,wannabe,103,16,119
4.189524856567395,2.2437859649658236,warhorse,7,8,15
4.953835494995118,1.6266708068847677,warmonger,7,3,10
4.80825814819336,2.719158744812006,warrior,1570,1986,3556
4.167956031799321,0.657193237304682,washer,32,10,42
1.7742546768188419,2.5707220001220676,wasp,566,371,937
5.428026786804196,0.04232213592530343,watcher,67,93,160
1.8638692779541017,-3.4796552658080913,waver,40,10,50
4.560855636596678,3.207326690673824,wearer,94,16,110
4.872716270446787,2.917585617065434,weasel,198,78,276
6.0846709594726605,2.3760013656616223,westerner,27,114,141
4.345860191345203,1.631177124023445,whale,1677,1475,3152
4.175326148986812,2.147355140686024,whiz,34,3,37
5.141096672058097,1.6410350494384787,wimp,9,4,13
4.8020555572509664,2.8233459625244066,winner,4292,1990,6282
4.854012191772469,-3.267094062805171,wiper,3,17,20
3.9970159378051804,0.2581723709106427,wisp,19,13,32
4.172607482910145,2.04956245422364,witness,1586,1783,3369
4.566751907348632,2.26610606384277,worker,1509,6464,7973
4.621513496398926,2.6464613494873035,workmate,4,4,8
5.402883666992189,2.4881123428344765,worshiper,9,56,65
5.322843017578123,2.5422619934082036,worshipper,25,112,137
4.163642730712887,2.2147465667724617,wrestler,969,1096,2065
5.337701484680167,0.06894181823729895,writer,11195,8004,19199
5.31962977600098,0.4072705078125125,wrongdoer,8,5,13
5.850989181518543,3.8815450439453016,youngster,110,118,228
5.528138565063465,2.4017090606689564,youth,5056,301,5357
5.232589019775389,0.32912341308593795,zealot,22,28,50
3.189420799255373,0.9078954086303597,zombie,601,342,943
2.6883830261230486,3.2660677566528307,zooid,17,73,90
