ss,pp,sent,s_freq,p_freq,freq
3.0669228863025673,4.16997062582573,aboriginal,830,72,902
4.2569459302020345,4.27916051710568,absentee,111,6,117
5.0581938457793125,4.194947055243874,accuser,39,38,77
4.553958190388485,4.131118468131746,ace,1494,295,1789
4.061555783613821,3.85313616218426,achiever,25,6,31
4.598417352921167,4.114657072531024,acquaintance,373,218,591
5.149124651573613,4.590646777101522,actor,8770,6109,14879
5.156301946559319,4.570925376666704,actress,5705,614,6319
5.277275620839994,4.5589142433183625,addict,145,72,217
4.372559040749142,4.485678528727286,adherent,66,352,418
5.073793278565548,4.469284664825594,administrator,782,492,1274
5.029386016249868,4.492163029168278,admirer,270,182,452
4.525652746630758,4.4002856960892665,adolescent,335,209,544
4.271876441189473,4.841215323450369,adult,5529,3574,9103
4.852222406823579,4.245551093939994,adventurer,192,152,344
4.491170811780179,3.8072914632405332,advocate,1365,653,2018
5.246649393560059,4.884451924943887,agent,5241,3117,8358
4.741696232710204,4.080905394205452,aggregator,443,12,455
4.920341398983869,4.3627329702813125,alien,3286,1309,4595
3.6183730624163264,4.26775526258619,amateur,2233,232,2465
4.521868147781051,4.005746615427521,amir,541,4,545
4.848888091565403,4.377898045524692,analyst,462,549,1011
3.9631706472777672,4.314462875602365,anarchist,566,321,887
4.400679048660164,4.437574312353094,ancestor,931,1088,2019
3.819160162203806,4.5300126520656985,ancient,6622,134,6756
5.196784304251766,4.746461417757747,angel,2602,1354,3956
4.729166597069611,4.4893440150258535,animal,5978,7775,13753
4.8913621077129825,4.432647030427658,animator,391,736,1127
5.266365157208201,4.777839111085052,announcer,324,99,423
4.830724402481785,3.8394846669832514,antagonist,884,345,1229
4.648589116033184,4.370816389440465,ape,207,372,579
4.794664122205571,4.174066256498367,apologist,31,24,55
4.800194514692876,4.4024494620903525,applicant,269,385,654
5.045540648968835,4.511957991395059,appointee,73,147,220
4.40494098085037,3.771925371954092,appointment,2742,656,3398
4.967802667559933,4.566816422011664,archer,950,324,1274
4.606149714739416,3.4394108614726076,architect,2373,1256,3629
5.05607249658625,4.256616246303558,artist,9094,7385,16479
4.9442874841076705,4.5317007407283505,assignee,10,5,15
4.727008043826041,4.631284314337172,assistant,5266,498,5764
4.09725650985634,3.9122294988196398,associate,1675,1268,2943
4.0653023022292025,3.9687364087105426,asthmatic,33,5,38
4.76425342240522,4.572218505659404,astronaut,433,438,871
5.096499828454315,4.52774072835326,athlete,1335,2410,3745
4.728373315177526,3.7057630185606616,attraction,1582,735,2317
4.768515320496068,4.050459881227074,auditor,184,97,281
4.831982351180178,4.061639823277536,author,7640,3461,11101
4.4953269381815435,3.967064965518194,authority,7524,5340,12864
4.99004637859654,4.583838418885815,avatar,888,182,1070
5.192569766238863,4.706502791935073,baby,4303,480,4783
4.609748121575285,3.7827661662967564,balance,2775,122,2897
4.9513975765271745,3.8657156959830523,banker,372,252,624
4.66806504961257,4.380810633029036,barbarian,318,163,481
4.756763392237479,4.412879560323885,bather,7,25,32
4.510643742723577,4.2664259892966765,bearer,374,150,524
5.221489251945696,4.761441349530841,beast,1214,238,1452
4.594644141818705,4.209901933287101,beater,46,11,57
4.429656659058223,4.771366847058323,beginner,59,78,137
5.167948306014999,4.46692365958652,beholder,54,3,57
4.741031004454555,4.738732771084166,being,69128,978,70106
4.664581595382472,4.428521247766936,believer,355,228,583
4.18269648907663,4.436740350628543,beloved,547,4,551
4.934018324201629,3.9485933883231272,benefactor,187,94,281
4.939982994353969,4.580177398519792,bidder,118,56,174
4.932490212572997,4.426787574370735,billionaire,174,31,205
5.237154349529332,4.5291346648143875,biologist,293,237,530
3.7777966697640935,4.227484241305044,bisexual,298,9,307
4.829307581251623,4.384114291104872,biter,12,4,16
5.24944155871354,4.527122392987998,blogger,162,89,251
5.072566220062521,4.725511373887384,blonde,641,31,672
4.869788175005267,4.303903105522826,boater,9,57,66
4.992492404679059,4.490342299502641,boatman,23,25,48
4.843890778800747,4.812437250521649,body,17987,5562,23549
4.972056042496963,4.3759151882628124,bomber,2167,2884,5051
4.788608621772239,4.344978623744769,bondsman,3,5,8
4.514160895247773,4.807527494004024,boob,11,18,29
4.810006275748288,4.221296184107896,bookmaker,37,73,110
4.651043786558967,4.128736319703192,boomer,66,27,93
4.370227424027364,4.452737806780396,booster,281,98,379
4.949818743907187,3.8786826033799464,boss,2156,471,2627
4.635591366524226,4.4585279020594974,bowman,455,22,477
4.7076156410113335,4.417008550111882,boxer,550,129,679
5.349946183888941,4.635083208551963,boy,7855,4928,12783
5.051518948209619,4.258994002270903,boyfriend,1689,74,1763
4.834378255945989,4.507726324101828,brawler,28,5,33
4.545224085685922,3.8990665875075745,broadcaster,515,297,812
4.789820461255861,4.182140378049134,brother,12442,6567,19009
5.169662278613046,4.770454570258746,brunette,74,5,79
5.14173235092394,4.491275174768582,brute,186,45,231
4.454736246615461,4.212964384425497,buddy,424,46,470
4.129739753217944,4.2740900207456,buff,458,42,500
4.554776393986971,3.9651260306630984,builder,492,431,923
4.694852898094407,4.474121556407848,bull,1696,585,2281
4.976584969951157,4.612647359312778,bum,81,24,105
4.884101658430948,4.181142588807642,busker,7,3,10
4.357897776585107,4.0499349077527995,buster,238,265,503
5.170683514506758,4.379234795539787,caliph,564,52,616
5.455022820312472,4.743831136700894,caller,146,39,185
4.7508737446629965,4.031749718547722,candidate,4275,2755,7030
4.238896129187738,4.55341537815951,capitalist,358,85,443
5.208237110949415,4.314186528820015,captain,13626,805,14431
4.53210583071696,4.546604396072352,captive,1064,352,1416
5.2952331141913564,4.667952231137644,captor,36,210,246
4.755502725254932,4.3973090231981615,carrier,3591,2397,5988
5.334268815054445,4.433949625112632,cashier,63,6,69
4.622759845152293,4.2103071229870555,caster,29,9,38
4.750507340217865,4.385117087798269,catalyst,402,145,547
3.523672352848063,3.283428059400025,category,6389,1759,8148
4.833552939207285,4.5645576882194945,caveman,20,21,41
4.835199602791251,4.227130332347986,challenger,456,153,609
4.050250521160752,4.052486755989831,champion,5322,4183,9505
4.578327992683384,4.16612789897901,changer,48,22,70
4.492528230405608,4.30446865515661,chap,46,23,69
4.902023150965469,4.382662367938833,character,34343,20753,55096
4.9957294173661175,4.555312704844534,charmer,33,6,39
4.89889864084857,3.9941321899709568,chemist,427,188,615
4.666985431134995,4.648513769930755,chicken,1204,264,1468
4.519250381186971,4.068898458888176,chief,12922,1421,14343
4.828433497410391,4.130050450488575,chieftain,219,180,399
5.22568667209676,4.713131252772612,child,10686,22791,33477
5.121506422574161,4.049283681558242,choreographer,343,68,411
4.370524416578444,4.189827825991863,chum,50,12,62
4.662635433656005,4.261015888169055,citizen,1644,4207,5851
5.2508960642323075,4.392515403611892,claimant,322,157,479
4.11042163195259,4.232761499493195,class,22588,3889,26477
4.718703337088662,4.450354481325041,classmate,285,358,643
5.082195411172389,4.718550699091718,client,849,738,1587
4.757546221842189,4.588015122240723,clone,530,430,960
4.245246199383942,4.561925197026845,closer,3303,30,3333
5.079240043719647,4.276569196063576,coder,5,8,13
4.436915795596592,3.924865237796025,collector,1208,673,1881
4.8325862847483805,4.591625507401851,combatant,110,295,405
4.398046411689993,4.245733419744559,comer,60,26,86
5.141438385897773,4.141041755503043,commander,11359,1979,13338
4.6623143702658805,4.275678446480953,commentator,705,1446,2151
3.9926509459261226,4.283274956605494,commoner,103,226,329
4.653981956280875,4.489062744732173,companion,1945,908,2853
4.276542182892909,3.416313922572746,competition,8431,1677,10108
4.670403531154681,4.425199448306479,competitor,670,1164,1834
4.979359651607275,4.726320307474804,computer,6158,1189,7347
4.951777715176442,3.963165402475985,comrade,138,420,558
5.200731014808394,4.284900560782081,confessor,201,12,213
3.211843597283215,4.330963723335621,conservative,3913,1056,4969
4.065482781248212,4.256556131106853,consumer,1085,700,1785
2.888428228215231,3.346849578973959,contemporary,7271,1034,8305
4.579325191282276,4.4388999366313655,contender,690,440,1130
5.103367121598033,4.578048727391792,contestant,600,631,1231
4.923405634537893,4.220989745965014,contractor,517,456,973
5.232483413961813,4.439613945085311,controller,1077,450,1527
4.043531744707346,4.274233242538955,coon,178,31,209
4.407625726273251,4.590000534586222,copycat,47,4,51
4.7257592360741825,3.9852301339626255,correspondent,740,161,901
4.642571248846135,4.364078360177269,cottager,4,12,16
4.7628106558123715,4.151099225642412,counter,3737,237,3974
4.844660073425429,4.443264287407397,courier,460,52,512
4.5372596713262165,4.436950695247798,cousin,2123,509,2632
5.084806816005479,4.508891124547679,coward,412,47,459
4.741778470892999,4.1635068706646585,cowboy,511,523,1034
4.4512103805885666,4.449661648741175,crab,499,351,850
4.524062813423759,4.482444706313933,craftsman,132,259,391
5.019817507251037,4.410136476312308,crawler,42,21,63
4.782232875769587,4.183105222170736,creator,2950,871,3821
5.507585637037691,4.754409132307199,creature,1566,1534,3100
5.069756387968667,4.25075336679526,creditor,49,282,331
4.873417915821335,4.408392606597948,creeper,61,18,79
4.235554669509732,4.013918794999755,crusader,424,719,1143
4.365440996025326,4.331916375386728,cultist,4,22,26
5.21739664641939,4.8180045748839255,dancer,921,1857,2778
4.335910485502357,4.474126538438062,darling,422,8,430
4.907521480489477,4.380311587031745,debater,31,12,43
5.104479898117596,4.195216983212619,debtor,50,156,206
4.662713942703567,4.465480427758433,decoder,16,4,20
4.825712094730919,4.47325220722931,defender,1208,1711,2919
4.359293478784677,4.5254030211844185,deist,23,23,46
4.812249439730548,4.48699643027077,democrat,1048,2107,3155
5.23757400392442,5.048649424704342,demon,1286,830,2116
4.82633266415421,4.442410289242302,denier,26,74,100
3.9756597338921082,4.149975582988139,descendant,584,1249,1833
4.584954816903112,4.7436451760474885,descendent,53,64,117
4.911793057355245,4.332536067790301,deserter,44,163,207
4.64847911042666,4.520863004571158,designer,3003,1167,4170
4.692118271696295,4.252101668490862,destroyer,2451,2839,5290
4.39308863706402,3.9319035061545,developer,1287,2254,3541
4.8309343806031375,4.098069128512526,devotee,164,289,453
5.132051856490973,4.227219550901067,dictator,558,69,627
4.897245521013291,3.7298505362664134,director,16935,2898,19833
4.980551928787094,4.3622814843256865,disciple,228,397,625
4.748270894649194,4.195164734622001,discoverer,126,90,216
4.62949949102121,4.364484263742222,dissenter,42,264,306
4.60192115774632,3.7856229056715662,distributor,538,299,837
5.060099952277772,4.648107033541898,diver,402,582,984
4.5976463484043215,4.138530894450653,divider,38,18,56
4.570062324301555,4.160695799503037,doer,8,11,19
5.052534127156807,4.539557798983747,doubter,3,20,23
4.970454325008589,4.541510354233907,drawer,85,25,110
5.040820022985493,4.516182251019462,dreamer,189,102,291
4.853669499742024,4.642457927132124,dresser,116,15,131
5.328660679165129,4.332021370505137,driver,3170,2734,5904
4.259564076873605,4.385322639961402,dropout,122,15,137
4.593567730103143,3.8270973580089223,dupe,16,5,21
4.92219091068465,4.6410049887454115,dwarf,1530,191,1721
4.891662885110097,4.613551262522607,dweller,49,146,195
4.992164772040541,4.628513622630075,elder,2150,349,2499
4.860924228786125,4.072661868614185,emir,290,77,367
4.798319469245765,4.425490189451409,employee,1165,3109,4274
4.835130672218046,3.8315626148272646,employer,701,562,1263
4.5044984265098105,4.367815440635177,enemy,7687,3948,11635
5.03480359949509,4.714519357623139,engine,7650,4212,11862
4.845072665205251,4.004369716719205,engineer,4249,2635,6884
4.67051097169222,4.503671278230204,enrollee,3,7,10
4.890017419426817,4.364820393513405,entertainer,392,198,590
3.4955339715412865,4.0407014334649265,equal,3697,361,4058
3.9840286642525395,4.117471870368705,ewe,73,102,175
4.672862734997015,4.003834693132978,exchanger,18,24,42
4.996994573859354,4.2210258635442965,executioner,139,52,191
5.134728724699803,4.516337969486049,experimenter,47,34,81
4.041521778286398,4.398844994187616,expert,1548,1285,2833
4.742704454769706,4.090277058647766,explorer,919,491,1410
4.98828964714891,4.447614736556712,face,10404,2002,12406
4.3685767650445975,4.3270032988247245,failure,5572,776,6348
3.805595534660423,3.991349956019448,family,35185,5277,40462
4.550443682357821,4.556722694111823,fan,5086,10304,15390
4.9116869029710415,4.2451743236742185,farmer,1513,1784,3297
5.023657161419489,4.076812452269152,father,22373,728,23101
3.80959468184923,3.9043534502205404,fauna,657,37,694
3.627438886813545,3.5980958319312837,favorite,3764,451,4215
3.6977662305860903,4.438534681511156,federalist,332,206,538
4.562409264664886,3.7912587614915036,fella,49,20,69
4.847253321590042,4.602830064078747,fellow,6041,492,6533
4.736983543373082,4.982869440077801,female,12596,4552,17148
5.083519588773667,4.582158429394708,fencer,41,8,49
4.84920079344438,3.973594939826187,fiddler,69,31,100
4.861998388553108,4.452931595936764,fighter,5058,3343,8401
5.239666761027802,4.635729122864516,figure,7057,6255,13312
4.7148189480991665,4.114188286165321,finder,123,40,163
4.671393203768558,4.123121786277824,finisher,218,162,380
4.353902747237493,4.744337800435078,flake,50,80,130
4.620374973340468,3.9467264419453745,flatmate,20,10,30
4.964606338157456,4.6490016540076695,flier,38,84,122
4.27915259727504,3.9580596297701103,flora,883,18,901
4.849967099700864,4.456911983824401,flyer,226,597,823
4.821007588379846,4.507741334834449,foe,270,292,562
4.650462260608412,4.567907445655694,follower,240,1792,2032
5.144539077012345,4.484866902113923,fool,558,220,778
5.0236228061096035,4.363608010230623,foreigner,132,542,674
3.9784174133117673,4.110609677181692,forerunner,415,132,547
4.594609960514239,4.402054167941063,fox,8099,510,8609
4.855631455472478,4.356814008863724,freelancer,63,18,81
4.9573413075899495,4.097240244704713,friend,9824,10015,19839
4.647150434037421,4.186545560970931,frogman,5,19,24
5.010357462440856,4.339867015301049,fucker,9,5,14
4.841078675869737,4.336211453722072,fugitive,346,141,487
3.7863239716020285,4.170716133315057,fuller,916,7,923
4.91940036403132,4.454660363606919,gambler,183,79,262
5.109835212605242,4.568789524377383,gatekeeper,94,14,108
4.481991165887008,4.499829175340254,gatherer,53,118,171
3.0055168666337693,4.142373936478517,gay,4156,174,4330
4.6023234450900805,4.449562712703976,geek,285,60,345
4.828823416767268,4.5240351821039635,genius,1206,75,1281
5.16014335546468,4.214962209647384,geologist,232,183,415
4.5931269104805565,4.435138619176115,giant,4076,3129,7205
5.299322638589066,4.861494940252149,girl,8590,5439,14029
5.041627116696166,4.141848421739191,girlfriend,1844,135,1979
4.6911505601421535,4.214998956493236,giver,51,9,60
4.610460638727604,4.354834262824875,goat,456,327,783
4.9365526957432575,4.40522243536047,goon,52,38,90
3.42266062885958,4.343807037230743,great,31055,109,31164
3.870968936619356,4.610673536768063,grownup,5,8,13
4.7616596935330975,4.429912020919446,grunt,86,103,189
4.557593922684706,4.538205256520072,guardian,3158,442,3600
3.912595573256244,4.281323757437292,guerrilla,627,350,977
4.4591149081389165,3.9705143218993886,guide,4317,735,5052
4.49107809616566,4.536612979858672,gull,180,169,349
4.846580825241842,3.8158594309011917,guru,332,97,429
4.210230888507143,4.296891623458986,gutter,56,40,96
4.956213002096076,4.4743803585568305,hacker,216,83,299
4.5310025030533225,4.175841331795461,hanger,51,35,86
4.8714248967164,4.4073656237505325,hater,31,58,89
4.7286404830984665,4.3218249615342295,head,21431,4830,26261
4.838225945831358,4.370911109662032,headman,34,23,57
5.20150044968614,4.759125390935678,healer,107,29,136
5.17645787816714,4.685895325835064,hearer,7,14,21
3.7495857947802467,4.009535214532667,heathen,173,82,255
3.8792880954532833,4.1136441839471765,heavyweight,1820,25,1845
4.912219888889515,4.488927890417298,helper,298,120,418
4.927087437805133,4.231427481546,hero,5235,1872,7107
4.179503318348802,4.313951026514065,heterosexual,280,24,304
4.593654543712669,4.5900376982831315,hobbyist,20,52,72
4.9082274139734015,4.187724022682799,holder,707,609,1316
4.93674457793413,4.268583675662006,holidaymaker,3,14,17
3.7140852422026214,4.190047198488246,homosexual,727,287,1014
4.161332823061137,4.334495013184874,honey,1016,3,1019
4.271614617980381,4.600228001281701,hopeful,260,26,286
4.261382183660652,3.967403834546449,host,4855,2168,7023
4.396335320941699,4.168039496449131,householder,118,43,161
4.824001451745463,4.319572099929603,hugger,10,3,13
4.892876656557677,4.252208071329122,hulk,695,25,720
3.8885102596595456,3.9131022936624316,humanist,232,24,256
3.4009547165666696,4.017576034995978,humanitarian,705,6,711
4.709749127457107,4.367541338941528,humorist,48,13,61
4.8675807754776255,4.355410235617164,hunter,2405,1345,3750
4.676929781175524,4.246771897384653,husbandman,24,12,36
4.042226162639979,4.599915895383456,hybrid,1404,491,1895
4.20954787526078,4.546114348621762,idealist,44,23,67
5.201245700894013,4.545701785178524,idiot,257,75,332
4.901988637449422,4.558715434758431,idler,24,11,35
4.9724785509951825,4.813318135777353,illusionist,29,4,33
4.902602079154956,4.192406668449157,imam,168,35,203
4.8190801644564125,4.163859986833252,incarnation,560,200,760
3.170587529902525,4.22282091419024,independent,9332,204,9536
3.9504108590091302,4.693341060768388,individual,9095,5814,14909
4.04384811519966,4.477564414088391,individualist,68,4,72
3.7695554295475358,4.052796713611805,inferior,883,10,893
4.9157573182044665,4.202987246313764,informant,197,95,292
4.763985731584139,4.2226269949781,inhabitant,80,2425,2505
5.091522477482702,4.693589894723969,initiate,520,183,703
4.399438375280544,4.396389501598744,insurgent,136,505,641
3.8082160407606835,4.079287666651279,intellectual,1618,375,1993
3.6423568139266127,4.117361512538803,internationalist,102,10,112
4.810544485764014,4.265120870442672,interpreter,309,104,413
3.6285795625467685,4.303536340544939,intimate,942,26,968
5.368371686081447,4.687672789717709,intruder,170,146,316
4.826948538166791,3.8948468064409987,inventor,450,97,547
5.0651631346500405,4.4396330829548685,investigator,315,689,1004
4.498986572975337,4.345245365439439,investor,282,966,1248
3.3344079469020578,4.381490271465198,irregular,954,99,1053
4.7029593008231,4.555086771207641,islander,205,587,792
4.353640269768256,4.658321873009454,isolationist,54,7,61
5.002022888761857,4.847479259514188,jock,184,16,200
5.2301036278747315,3.953480458007766,judge,4872,1916,6788
4.82772888391211,4.38241549704146,jumper,233,105,338
3.8093649582785094,4.206846039837192,junior,4573,210,4783
4.586781256772538,3.8167335225687253,jurist,112,80,192
4.067237023607703,4.725500785999488,juvenile,1216,771,1987
4.5944777879744425,4.011324763651409,khan,2611,21,2632
5.330252466698651,4.730284188292355,kid,1678,2277,3955
5.247865440850733,4.494211800930003,kidnapper,51,73,124
5.1248656585680425,4.588837030846893,killer,2162,363,2525
4.8419760927917554,4.34452098750698,knocker,19,6,25
4.984903319264756,4.580977522377461,lad,452,79,531
4.462691699948024,4.279501700781692,lamb,1003,205,1208
5.0401527086329825,4.543505764679464,lawmaker,21,116,137
4.744802247635873,4.635118569616722,layman,67,100,167
4.972444282340696,4.14608778493692,leader,10593,6269,16862
4.861623671838226,4.3472916410261675,learner,34,55,89
4.510000709144572,4.427515603022888,leech,216,48,264
4.3849746295769965,4.237561541018183,lefty,76,18,94
3.486218830903745,4.1565299951123755,lesbian,1155,315,1470
3.3007620977501695,4.308799378750916,liberal,3578,829,4407
3.334436757007728,4.086062536580901,libertarian,345,44,389
4.6907863115255015,4.163315554969193,linguist,135,122,257
4.783129266939387,4.298742881428957,lion,2318,1555,3873
4.825924735012629,4.416362090074877,liquidator,14,3,17
5.3473343315603135,4.485862705610796,listener,493,910,1403
4.360514975291947,4.452626053585165,logician,9,8,17
4.909980353623082,4.465796352865921,loner,89,9,98
4.765442617711114,4.164040773956508,looker,7,4,11
4.79496420132841,4.327302600291153,lord,9878,2043,11921
5.03403025551475,4.5183933952062105,loser,332,101,433
3.744888802206157,4.285377717806007,lot,6579,982,7561
4.516335326201537,4.5606498465438055,lout,5,4,9
4.941579573774835,4.479609727022259,lover,1724,878,2602
4.86947051559765,4.479199907951212,lunatic,154,37,191
5.125202510836386,5.116939532540734,machine,7173,1647,8820
5.117583562346168,4.423270483593404,magician,286,100,386
5.10757929996484,4.3142475012606045,mailer,32,4,36
4.734372815565351,3.7697504406005873,maker,998,646,1644
4.842127706806107,4.82187774305021,male,9170,4774,13944
5.341906437928166,4.787789249160454,man,30762,32879,63641
4.482471218075654,4.3282152527737665,marcher,83,105,188
4.9180804907264015,4.0650613017167885,mascot,689,140,829
4.513597231946916,3.672478867272824,master,6147,1962,8109
4.660639090457048,4.369335480040975,mate,1933,788,2721
4.351563135983797,4.641883244537663,materialist,37,3,40
4.697174096305318,4.285713853470453,mathematician,445,244,689
4.713403911736412,3.984446165829331,mentor,879,86,965
4.6310497018510315,4.713273815360036,mercenary,329,507,836
5.10876826756078,4.473892620933638,messenger,644,245,889
4.06718346787766,4.246680567178272,migrant,271,387,658
4.404843908616847,4.256232989977628,millionaire,439,101,540
3.557203783242267,4.281156662340928,minor,9647,325,9972
4.1295248772721465,4.519668290883507,missionary,872,796,1668
4.416451034780861,4.1257369379962086,model,8931,4412,13343
4.327999016223769,3.759378339369041,modeler,7,14,21
4.04317856417625,4.2880716276483,modifier,12,23,35
4.858826079294406,4.203833469959756,moneymaker,14,4,18
5.094146846435553,4.701853781017817,monster,2710,1545,4255
4.9922115584399585,4.882237667106795,moron,20,10,30
4.525209104855957,4.954843992079189,mortal,1050,66,1116
4.509062175333799,4.14568281394982,mountaineer,132,278,410
4.927184911168082,4.659968020065234,mouse,1447,563,2010
4.964825066935118,4.5470219070859645,mover,97,45,142
5.185735439742528,4.325843939131296,murderer,536,180,716
4.537975447724511,4.434570104672947,mutant,417,209,626
4.6613143527700664,4.4736054482321705,mute,191,17,208
3.7295688531443982,3.9682978170303613,namesake,443,19,462
2.860917194193684,3.4395100750944074,national,45586,624,46210
3.387963918020544,4.046567633818224,nationalist,1439,581,2020
3.527998081879897,4.428053134841532,native,8244,910,9154
3.4016105690225675,4.363538428941192,natural,10166,82,10248
5.090560086668241,4.362470094336876,navigator,307,77,384
3.971762734919686,4.22157071658749,nazi,2747,791,3538
4.911223553754743,4.529561431458124,neighbor,651,678,1329
4.523478812136325,4.051569440139955,neighbour,306,980,1286
4.441588499126276,4.420932256890543,nerd,79,51,130
4.305680518324424,4.585166883470201,nestling,69,203,272
5.0367464259330195,4.354796456764118,newsman,16,6,22
4.71517582025429,4.370173592704008,novice,133,38,171
5.144460718212674,4.381042677738959,objector,28,44,72
5.017874910914648,4.472001729313398,observer,1706,1213,2919
3.6952095447147606,3.8501720204793344,occult,282,4,286
4.535454740252799,4.256990676943129,occultist,64,28,92
4.550516733948109,4.349764057547784,oddball,39,4,43
5.023211888272119,4.157621389662568,offender,149,200,349
3.5512866083017993,4.373396611470888,official,14224,7271,21495
4.591085645162682,4.365027948473076,offspring,959,8,967
4.568735253949393,3.9039034033296947,oiler,77,513,590
4.893146235766771,4.347285892866884,opener,915,145,1060
5.054670346429946,4.187263467724552,operator,1272,950,2222
5.087315017866365,4.123382092716453,opponent,2661,3149,5810
4.394829796240733,4.45822580156565,opposite,3650,104,3754
4.0933310437623245,4.010056997907329,opposition,5996,33,6029
5.042895209404968,4.765425760005154,organism,612,1676,2288
4.239512537439714,3.9791849884882797,originator,73,32,105
4.480782316482241,4.271222423082802,orphan,293,228,521
4.875641755216579,4.605374020936351,outdoorsman,13,4,17
5.0673040106700356,4.44049579825889,outsider,288,219,507
4.90741854628962,3.9931514462614626,owner,4043,3208,7251
3.7100289286376817,4.442952308095537,pagan,1001,113,1114
4.262891808726227,3.991883156328223,pal,393,79,472
4.103513354505456,4.303310381279889,pansy,16,4,20
4.824131973418442,4.66235985876229,parasite,480,689,1169
4.5857904942925,4.239384100662878,parent,1965,7259,9224
4.233311886357281,4.154317480841707,parliamentarian,225,228,453
4.725762108189233,4.350162293110147,parrot,485,274,759
5.007728053918832,4.681985573339151,participant,503,1763,2266
4.050015018476124,3.8428138308518385,partisan,1034,924,1958
4.764502284825184,4.354241138699736,partner,3356,1725,5081
4.461837716198852,4.273857210620358,party,26195,4288,30483
4.637487329236951,4.078907275137663,pasha,580,8,588
4.714894086896209,4.485775213909216,passenger,3612,3795,7407
4.687451368054122,4.370328385754897,passer,272,66,338
5.3123510866095405,4.471620832624538,patient,1587,2039,3626
4.3094655771605535,4.271112618911712,patrician,91,102,193
4.202093189587613,4.27916130100254,patriot,574,635,1209
4.698475436847501,4.21066646859517,payer,32,28,60
4.145938396870337,4.614947809986539,pedestrian,581,236,817
4.619060290138281,4.346832462187953,peer,556,986,1542
4.981583341597268,4.731312407687419,perfectionist,145,9,154
5.182592010113652,4.729361365601958,performer,1139,1440,2579
5.216432864755873,4.68336950134907,person,11675,49224,60899
4.972837186733507,4.56784232342776,personage,31,38,69
4.184730441170812,4.202381313192122,pet,980,387,1367
5.0158445313235305,4.165157264655289,petitioner,56,66,122
4.861674846202927,4.284000485234731,philosopher,1071,527,1598
5.06886719633858,4.402516222322305,physicist,630,364,994
4.827762049850206,4.1937783919383875,picker,36,35,71
4.9573371029672995,4.6723717979480615,pitcher,1788,547,2335
4.792245358178782,4.623577495723996,planet,6078,2394,8472
4.7611682699363325,4.685389707568962,planner,153,377,530
4.439956155173771,4.622584240360068,plant,7415,5599,13014
4.332175831530408,4.180380043507123,planter,112,105,217
4.213229187514832,4.461787267096593,plantsman,4,7,11
5.05749523030928,4.524062076994296,player,27922,20973,48895
4.423158088710178,4.285469030806855,pleaser,25,3,28
4.816200879585294,4.425283901837714,plotter,27,166,193
4.906526220886386,4.141102314748032,poisoner,18,7,25
4.807290564680141,4.408399084851654,politician,1622,1734,3356
5.121079105803242,4.636265520023283,possessor,44,12,56
4.7844113097958125,4.5637006984774615,poster,893,675,1568
4.515300006319807,4.25950956117774,potentate,5,13,18
4.6426647163443135,4.369154146460062,powerhouse,224,22,246
4.358541414825549,4.3901739147556285,prayer,1689,515,2204
4.143605244557326,4.193903049550036,precursor,807,238,1045
3.5684587591507313,3.51598813241476,predecessor,2358,1121,3479
4.913312905112939,4.3839784247225495,presenter,374,82,456
4.41945020280626,4.342212891108979,preserver,23,8,31
3.575356431887533,4.405638656638445,primitive,1094,31,1125
5.071506983903715,4.379073037753068,prisoner,2082,4335,6417
4.970933655147011,4.700564847898928,processor,369,188,557
4.80689714416204,3.891432916000012,producer,10663,5972,16635
3.542466533115432,4.548465525961756,professional,9659,775,10434
4.69043266593285,3.949656026432221,profiteer,4,8,12
5.1430243557929884,4.681749260792536,programmer,376,275,651
2.9460069822724453,4.046720560434094,progressive,1974,66,2040
4.973438370854296,4.596051392089727,prophet,560,211,771
3.9141842344990714,4.348858122476395,proponent,358,467,825
4.671374167427908,4.2889072396688785,prospect,1495,695,2190
5.252690443490394,4.430146374284064,protagonist,2821,726,3547
4.076859246524913,4.337560992825738,protectionist,83,16,99
4.815498220474014,4.327980728455506,protector,494,89,583
5.037868814277498,4.716260539021192,protester,79,834,913
4.477544055195258,4.703184995384236,psychic,426,13,439
4.711755460887218,4.458147330235253,publicist,216,26,242
4.799277893173688,4.2293298815836575,puller,70,5,75
4.897982266250741,4.455210643287785,punter,140,15,155
4.725845402688639,4.42075732205751,pupil,643,1177,1820
4.887201282524952,4.562082008242076,puppet,757,391,1148
5.0141880152054945,4.6470641405289115,pursuer,34,129,163
4.835079839365845,4.381511349943805,pussycat,98,10,108
4.34845339284951,4.178346587140277,qualifier,295,178,473
4.45182422128995,4.276064211090327,quarryman,7,121,128
4.9846361313515395,4.2767382408551615,queen,11098,1166,12264
3.6606881327223757,4.584393161462536,radical,2099,337,2436
4.284389723806523,4.212993529606123,rafter,39,110,149
4.512792076435485,4.0994028923630825,ram,1117,524,1641
4.680379876211719,4.65677290637219,rat,917,913,1830
4.41634405377272,4.455216324491522,rationalist,56,5,61
4.771106654452774,4.33032238837122,raver,26,3,29
5.039255063771867,4.020433908057738,reader,1645,2530,4175
4.432465180311853,4.6134626276357675,realist,175,20,195
5.104703508521261,4.580259329683697,receiver,1075,346,1421
4.88326427667757,4.407925261763628,recipient,942,539,1481
4.348583578328309,3.9078879896810026,reformer,262,373,635
3.517535016474861,4.145718496854281,reformist,152,26,178
4.740850149797039,4.017703467541791,regent,858,329,1187
3.3042846517158715,4.733431996990916,regular,10127,541,10668
3.411891358679938,4.109621128592098,relative,3500,1927,5427
4.0068486187187204,4.201021578936524,relict,45,6,51
4.753226197515577,4.41449879138445,reliever,130,38,168
4.748291802744449,4.38534051193461,renegade,168,60,228
4.470536168213849,4.330872905625476,repeater,23,24,47
3.9272300106305646,3.9569883410367854,replacement,3695,469,4164
5.398509999531509,4.936858842884435,reporter,2158,960,3118
4.135732854187305,4.07717025710126,representative,3604,3665,7269
3.7390930044058326,4.421750538244639,republican,5703,1900,7603
5.076066541350853,4.333071749230735,rescuer,35,129,164
4.861820170898646,4.341964300583122,researcher,573,2025,2598
4.138577601773088,4.4782105599695505,resident,2894,6817,9711
4.522761581463547,4.197393024593136,resister,7,31,38
4.825894128713612,4.21779493576785,respondent,74,285,359
5.173204807431256,4.5275258474021935,responder,19,53,72
4.1476616093302585,4.003029882463997,retainer,72,113,185
4.280622655408029,3.929511120140731,retiree,6,30,36
3.319338156139418,4.250706369579257,revolutionary,3007,415,3422
3.813250637854571,4.377029267888439,revolutionist,13,9,22
5.054682220153079,4.45501055303904,rider,1748,2746,4494
4.696686521626251,4.3942519334428365,ringer,61,34,95
4.4915341359755185,4.291221702223778,riser,34,15,49
3.9074094881468096,3.7348633582984867,rival,3393,1796,5189
4.204156747869412,4.484584455747603,rock,20733,2453,23186
4.116789789899954,4.4702889085740996,romanticist,20,4,24
4.9806008359642515,4.399970721155601,roommate,220,69,289
4.129796310949297,4.122389702940003,rounder,239,35,274
4.906828960207257,3.681504618727576,rover,243,1019,1262
5.063418386705013,4.056975676080146,ruler,2020,1278,3298
4.367259161436033,4.258270762848229,runaway,369,62,431
4.976988840138967,4.664752323398922,runner,1782,1214,2996
4.5424491425977465,4.199863732569387,runt,25,3,28
4.788017137771623,4.3984467547960655,rusher,124,44,168
4.871520160247286,4.19414357870874,sacrificer,4,3,7
4.488772319727239,4.004731155343498,saint,7507,1553,9060
4.983643471718354,4.326807243250817,salvager,4,6,10
4.35546698387145,4.319524178533946,samurai,255,4,259
4.4770321416533,4.713587249151791,satellite,2778,536,3314
3.6827469789295186,4.557167408109979,savage,1243,89,1332
4.662765124922437,4.179605020130596,saver,22,14,36
4.982650131484368,4.579945513295627,savior,197,18,215
4.679310998097035,4.034171815290126,schemer,14,4,18
4.778791168845407,4.410927563714328,scholar,2260,3394,5654
4.667793494261179,4.035467211133945,schoolmate,43,54,97
5.026997888594188,4.564246408093336,scientist,1552,3121,4673
4.687306522163411,4.285450723157593,scorpion,175,121,296
4.583749991402049,4.061561162545196,scout,1937,1222,3159
5.175958395538018,4.5346570965879796,screamer,6,13,19
4.874673999699063,4.509820271602017,scrubber,7,7,14
4.844591685123262,4.266679870787765,searcher,25,49,74
3.930412278379068,4.389029439542615,secessionist,90,29,119
3.4523376941214448,3.9442697280549446,secular,1092,3,1095
3.6980605759157115,4.122717055325911,secularist,9,7,16
4.9566281582556115,4.3823050113113915,seeker,96,196,292
4.861685676698446,4.5112151398040545,seer,72,13,85
4.347449197947906,4.0600820291675905,selector,111,417,528
4.729839087810534,4.448294369496541,self,10629,83,10712
5.191184431720549,4.641050503920084,sender,40,11,51
3.641928080941293,4.395923264177867,senior,6947,291,7238
4.940094361162492,4.662762671908224,servant,932,1108,2040
4.768048466485984,4.489137272356134,shaker,89,36,125
4.6619837341980706,4.5960352026857745,shark,3428,2071,5499
4.405877802238084,3.9150210683959568,sheikh,311,55,366
5.410186455072713,4.291724577880581,shooter,949,311,1260
4.704611535684787,4.203708464879938,showman,80,12,92
4.296173976039977,4.736677800818681,shrimp,352,67,419
4.513501305454101,4.379652300418037,sibling,242,1035,1277
4.545360837542262,4.223276840685967,sidekick,199,33,232
4.861770281072813,4.025525017393106,signaller,15,43,58
4.96604184301245,4.494883337283401,signer,38,121,159
4.526459270571042,4.376566703912681,sissy,18,3,21
5.08918055850447,4.589479842224078,sitter,144,33,177
4.573758768476024,4.659717689409396,slave,2202,2469,4671
4.567313094497562,4.329171964169234,sleeper,244,101,345
4.501690550569629,4.3149697833312555,slider,124,28,152
4.706114640362474,4.07205400651233,slinger,8,12,20
4.126675376203476,3.856371060669547,smith,11915,209,12124
4.887292200216832,4.393426245665745,snake,1742,725,2467
5.124676867878554,4.384201259537194,snatcher,22,40,62
5.063104079756549,4.4130828425646005,sorcerer,270,50,320
4.404567723319406,4.136473716882037,source,8045,6796,14841
4.726449178269581,4.237677995371614,sovereign,1265,128,1393
5.1208838454383105,4.492894266798219,spaceman,67,7,74
4.543797062041655,4.291933445448143,spade,86,65,151
4.735436337723309,4.415912185686588,spearhead,131,42,173
3.7954195426737733,4.2744839523515115,specialist,1207,385,1592
4.409660120696083,4.210180702947024,specifier,3,5,8
5.141153852209699,4.62480693647929,spectator,442,1348,1790
5.291380656800431,4.731541607632414,sphinx,61,8,69
4.148062575892995,4.016225423082515,splitter,45,13,58
4.2947090690366565,4.143626764055471,spoiler,78,67,145
4.605906227541793,4.537723693401059,sponge,263,274,537
4.2757619710905885,3.5491212912911028,sponsor,723,507,1230
4.2486093129652485,2.327539792909377,sport,3920,7486,11406
4.732241246334993,4.426371483195611,spotter,78,53,131
4.644672604307068,4.24229810576524,spouse,154,127,281
4.73014359009299,3.9045554506404887,stakeholder,14,78,92
4.611557307661602,4.736231454633925,star,22042,11432,33474
4.491519765278621,4.42722554875531,starter,928,237,1165
4.894437682279451,4.139256610668536,steward,350,201,551
5.316996461261862,4.604439150209691,stranger,707,303,1010
4.483841319427219,4.327675483028646,strikebreaker,3,27,30
4.779885854893955,4.13948751563238,striker,1037,273,1310
4.483400022964629,4.162727237297174,stringer,86,22,108
5.105289251296343,4.54942597492736,stripper,146,102,248
4.59584090409164,4.557427276525619,student,7009,11675,18684
4.817472304449337,4.190360010880802,subject,8316,2649,10965
4.2508785007045695,4.19985301042534,substitute,1824,209,2033
3.6836358858506593,3.6056948863963036,successor,3119,590,3709
5.066546237477025,4.726666116389293,sucker,150,71,221
5.094158442804973,4.372997934982868,sufferer,47,77,124
5.020837452134915,4.272653175517284,sultan,1768,71,1839
3.9795801642981914,3.90987569263414,superior,3078,408,3486
4.384897822949592,4.205824592953331,superman,1174,18,1192
4.46262046095981,4.170460853077637,superstar,488,287,775
4.3679909160778525,4.350497567920799,supporter,1286,4151,5437
4.823759426279482,4.478543710526118,suppressor,39,11,50
4.839749452500408,3.9092804703944104,surveyor,413,111,524
4.314507130793258,4.489587135725172,survivalist,5,4,9
4.7470678030308875,4.459964456587732,survivor,1246,2755,4001
5.244005201630001,4.574559336416996,suspect,1121,795,1916
4.7916987524806505,4.704162075684479,sweater,156,45,201
4.321018598210969,4.29874946200141,sweetheart,241,36,277
5.223213176981602,4.698493722966791,swimmer,508,319,827
5.05094079709629,4.760467325790669,swordsman,71,20,91
4.494718436613217,4.920811257449278,tactician,53,17,70
4.9063557909592905,4.603616115905783,tapper,29,4,33
4.847468860872697,4.033503204061455,tease,115,55,170
4.212402598776871,4.241836998938446,teaser,488,43,531
5.313794202901306,4.675282459756579,technician,275,319,594
4.991876521502617,4.686011362073783,technocrat,5,8,13
4.988616211175293,4.330458177215432,technologist,12,8,20
4.661393708263326,4.757456046745402,teen,1277,435,1712
5.319990265500376,4.791605687839288,teenager,893,666,1559
4.808157145019164,4.2419995766702225,terror,1019,48,1067
4.581516806263094,4.369755145483813,terrorist,911,385,1296
4.341706305495272,4.42089690997153,theorist,250,270,520
5.4503609660742836,4.656610469147212,therapist,159,61,220
5.111277957970723,3.9768448623777903,thinker,129,202,331
4.294985440374571,4.377452612253533,thoroughbred,319,119,438
4.876637587781136,4.4177765047437685,thrower,72,163,235
4.682353630920197,4.174175143269952,tiger,1842,1700,3542
4.55484826593255,3.9301379973772885,tinker,300,11,311
4.219885773912477,4.4776835361669995,tool,1291,1731,3022
4.686603160749463,4.266614299998876,topper,138,24,162
4.0821980885335964,4.773939311708499,tourist,1593,1453,3046
4.6446083599589265,4.519285544692558,townsman,3,26,29
4.852871291655797,4.249178893845812,trainer,694,326,1020
4.1700350750224455,3.901172416790331,transfer,4003,437,4440
4.9681167261531645,4.354535382140689,translator,340,110,450
4.973473853699652,4.677488897810054,transmitter,237,115,352
4.765023472956544,4.460582706390502,traveler,264,565,829
4.767852141540871,4.032026462263309,traveller,338,296,634
4.962414742633554,3.6374969652605245,treasurer,664,19,683
4.55964992740952,4.520330883193106,trimmer,191,23,214
5.04001085453238,4.462628112551757,troublemaker,49,21,70
4.538718174650636,3.761003957784691,trustee,438,1088,1526
3.59634411012199,3.753167186547902,turner,2043,10,2053
3.7703218095197215,4.755413239061731,twin,3171,1065,4236
4.917319752854075,4.284901106155296,tyrant,321,108,429
3.875486930836665,4.192498088308774,unionist,175,134,309
5.0974373027731765,4.455327648759841,user,1624,2111,3735
4.869871636130554,4.56535649506664,vacationer,3,18,21
4.599635581134473,4.165753399150274,vassal,359,179,538
4.121932361252448,3.684467531274146,veteran,1797,1772,3569
5.336923759236132,4.420764308239875,victim,1791,3195,4986
4.811039418968601,4.270929025267915,victor,2341,166,2507
5.30008648314031,4.357389539763636,viewer,1001,7379,8380
4.678159061860516,4.330540304427082,villager,61,671,732
4.973864942981924,4.0238784211619105,villain,1466,866,2332
4.6288368842595276,4.376624149713951,virgin,2202,77,2279
3.933263692692405,4.428233811396298,visionary,215,11,226
4.946234261038022,4.457637065633298,visitor,1018,3227,4245
4.386082071124152,4.568145463597697,volunteer,1614,2063,3677
4.460064773026664,4.164982116728909,voyager,815,13,828
5.209110216146133,4.653131812546047,waiter,176,51,227
4.563584235521683,4.6864752731005,walker,2773,235,3008
4.8568581568141305,4.247942935318999,wanderer,101,815,916
4.13102733876082,4.502620039020146,wannabe,103,16,119
5.118355206423352,4.6325196847037695,warrior,1570,1986,3556
4.723610008613159,4.394015433703551,washer,32,10,42
4.850926313457469,4.444143437599125,wasp,566,371,937
5.08116218223493,4.574576310266934,watcher,67,93,160
4.710795767318308,4.444165802832865,waterman,75,7,82
4.649074683125365,4.376449039446932,waver,40,10,50
4.92385092511484,4.412599765659891,wearer,94,16,110
4.86254304156054,4.316398917566282,weasel,198,78,276
4.035394160506748,4.153109981793724,westerner,27,114,141
4.404090898663377,4.6133959139279686,whale,1677,1475,3152
4.467159745079648,4.227219754092063,wimp,9,4,13
4.8611690682208355,3.901612301348619,winner,4292,1990,6282
4.83423543939651,4.509289929564037,wiper,3,17,20
4.938292188545887,4.591750555346431,witch,1227,594,1821
5.05090165896557,4.260015957952438,witness,1586,1783,3369
5.0477589777355725,4.621868532358196,wizard,754,433,1187
5.368695780525698,4.766545416994065,woman,11305,21958,33263
4.784518425793079,4.4032270788023435,worker,1509,6464,7973
4.459888876707053,4.226116419852563,workmate,4,4,8
4.766309568712844,4.323706861482927,worshiper,9,56,65
4.824097476977283,4.563218093331523,worshipper,25,112,137
5.046162094407858,4.371569071075468,wrestler,969,1096,2065
4.732058671390609,4.053749350258871,writer,11195,8004,19199
5.082617234652725,4.639592548808556,youngster,110,118,228
4.36059077586299,4.574739418203023,youth,5056,301,5357
4.761675557270083,4.856626876018883,zombie,601,342,943
4.234567180919191,4.264014971341847,zooid,17,73,90
