s,p,sent,s_freq,p_freq,freq
-1.4430393039473817,2.5621755903508845,aboriginal,830,72,902
-0.9766680521929842,2.2079023100877144,absentee,111,6,117
2.708108131140344,2.8739334241228196,accuser,39,38,77
0.1519085657894781,3.2566431451754436,ace,1494,295,1789
-0.44072272587718864,2.282399760087708,achiever,25,6,31
0.8678501241228052,2.2349342030701926,acquaintance,373,218,591
2.6311015460526246,2.5997043868421006,actor,8770,6109,14879
2.6170767166666824,2.612789524122828,actress,5705,614,6319
0.6382608249999926,2.871851616666671,addict,145,72,217
0.6526323565789536,2.5339725596491185,adherent,66,352,418
2.0218735710526374,1.9615288728070102,administrator,782,492,1274
0.9216061407894713,1.723663203947373,admirer,270,182,452
-1.1842553903508737,2.991350364912295,adolescent,335,209,544
-0.4210078986841914,2.9229225166666595,adult,5529,3574,9103
1.0199217307017623,2.568913619736847,adventurer,192,152,344
-0.2938604061403378,3.008477989473686,advocate,1365,653,2018
2.103643819736865,2.101774322368433,agent,5241,3117,8358
0.686045180701754,2.8299629828947257,aggregator,443,12,455
-0.3438761184210488,2.394606326315799,alien,3286,1309,4595
-1.2034013684210478,2.6113857828947165,amateur,2233,232,2465
-0.16130942763157208,1.9823411447368393,amir,541,4,545
1.9251858596491171,2.8034528149122835,analyst,462,549,1011
-1.48224019736843,3.077540924561397,anarchist,566,321,887
0.30622071929825445,2.4312422947368546,ancestor,931,1088,2019
-0.9599554109649056,2.287563595614028,ancient,6622,134,6756
1.8840101833333325,2.751762999561393,angel,2602,1354,3956
1.6934341254386034,2.7227093960526254,animal,5978,7775,13753
-0.37660338114036307,2.5242090131578934,animator,391,736,1127
2.281784822807019,2.195974596491242,announcer,324,99,423
0.767623928947371,2.7966811614035194,antagonist,884,345,1229
-0.11100133245613542,2.8872509763157908,ape,207,372,579
-0.0723298065789546,2.90219468157896,apologist,31,24,55
1.8115266228069995,2.3806795333333337,applicant,269,385,654
0.4949748210526259,2.5941363850877206,appointee,73,147,220
0.48704936228068973,1.6178952429824651,appointment,2742,656,3398
2.1432704017543944,2.041137070614033,archer,950,324,1274
-0.27930569342104583,2.635296809210516,architect,2373,1256,3629
2.4262762096491084,2.409070567982452,artist,9094,7385,16479
0.8354453153508672,2.2038172921052617,assignee,10,5,15
-0.11227013377192918,2.4908081548245544,assistant,5266,498,5764
-0.43780035438594744,2.7235256543859663,associate,1675,1268,2943
-2.0336568425438504,2.982778660526316,asthmatic,33,5,38
-0.7188029684210449,3.1563951517543902,astronaut,433,438,871
2.323887681140345,2.411756037719293,athlete,1335,2410,3745
1.2333952083333237,1.9603609605263213,attraction,1582,735,2317
0.5943075526315607,2.1738261666666627,auditor,184,97,281
2.6965120337719224,2.77979117105264,author,7640,3461,11101
1.5535611565789438,2.3482942057017535,authority,7524,5340,12864
0.00045436271930121563,2.9649130087719335,avatar,888,182,1070
2.164821935964902,2.3636296026315673,baby,4303,480,4783
1.5590574057017577,2.8233008214912285,balance,2775,122,2897
2.087593610964909,2.7695052017543986,banker,372,252,624
-0.09343240745615233,2.221219425000017,barbarian,318,163,481
1.246709372368418,2.4890930921052448,bather,7,25,32
1.5488893039473854,2.3721831140350904,bearer,374,150,524
2.0246541469298194,2.129143439912296,beast,1214,238,1452
0.12760885307018377,2.547811021052624,beater,46,11,57
-0.7431459850877111,2.615031895614033,beginner,59,78,137
2.216631619736841,2.5160791964912175,beholder,54,3,57
0.7473347372806991,1.9634846535087593,being,69128,978,70106
-0.8205849846491269,2.3582881412280603,believer,355,228,583
-1.527215596052633,2.504625038157906,beloved,547,4,551
1.5286069934210484,2.199810035964891,benefactor,187,94,281
1.6347837833333294,2.664318939912283,bidder,118,56,174
-0.6633214065789517,2.786547467543855,billionaire,174,31,205
0.18995189824562786,2.8911574934210638,biologist,293,237,530
-2.0220417824561387,2.9055232118420964,bisexual,298,9,307
0.8897651500000006,2.3021342149122876,biter,12,4,16
2.705280885087708,2.8876959706140504,blogger,162,89,251
2.12178886929825,2.5333149881578994,blonde,641,31,672
1.01596891359649,2.8362970324561356,boater,9,57,66
1.8914075276315927,2.5254652552631693,boatman,23,25,48
1.550191330263166,1.6749371407894902,body,17987,5562,23549
1.2591315350877235,2.416364584210543,bomber,2167,2884,5051
1.9614210600877104,2.3433957938596564,bondsman,3,5,8
0.17772562105262857,2.6898268271929844,boob,11,18,29
0.03232153640349189,2.8117000390351183,bookmaker,37,73,110
0.2703408499999931,2.8577348421052573,boomer,66,27,93
0.9843551302631486,2.99392900614035,booster,281,98,379
1.1837212504385963,2.1576342513157805,boss,2156,471,2627
0.8068807614035087,2.728554433771942,bowman,455,22,477
0.49526553640349746,2.225101632456136,boxer,550,129,679
2.1901565508772,2.4318896802631667,boy,7855,4928,12783
0.8001691127192938,2.7458612087719327,boyfriend,1689,74,1763
1.5036848785087713,2.17064972850876,brawler,28,5,33
0.9976411837719183,2.553746677192981,broadcaster,515,297,812
1.4880016837719339,2.182402803508772,brother,12442,6567,19009
2.3211584171052486,2.4970193307017627,brunette,74,5,79
1.6161463057017595,2.3584731521929747,brute,186,45,231
-0.41376246710527376,2.3624418807017484,buddy,424,46,470
-1.0257778530701813,2.4061051662280715,buff,458,42,500
1.38454564385966,2.558240087280705,builder,492,431,923
1.3506185789473655,2.827246514912293,bull,1696,585,2281
0.6399364776315739,2.349309071491229,bum,81,24,105
0.22434760964912748,2.7879421087719294,busker,7,3,10
-0.6869925438596365,2.4612132758772045,buster,238,265,503
2.1835889,2.820492125877186,caliph,564,52,616
1.6436226508772105,2.402674122807012,caller,146,39,185
1.4923372614035273,2.1170066565789405,candidate,4275,2755,7030
-2.042274493421033,3.2936414302631594,capitalist,358,85,443
2.2619312399122844,2.259825361403511,captain,13626,805,14431
-0.7083855907894705,2.289230542105276,captive,1064,352,1416
2.1738721473684173,2.2814605688596608,captor,36,210,246
1.7629535719298168,2.3962615057017302,carrier,3591,2397,5988
1.991973123245602,2.4996479934210427,cashier,63,6,69
0.8339292929824715,2.4696580973684092,caster,29,9,38
0.9376341859649102,2.8699918776315734,catalyst,402,145,547
0.10565452061404201,2.383386299561405,category,6389,1759,8148
0.3333326653508788,2.8464940592105386,caveman,20,21,41
0.7702526627192903,2.6568732228070324,challenger,456,153,609
0.2376409907894672,2.821501524561393,champion,5322,4183,9505
1.151256621052653,2.4041530267543774,changer,48,22,70
0.22596106754384948,2.6372864008772066,chap,46,23,69
2.420246835964912,2.8988958394736706,character,34343,20753,55096
0.8730801618421076,2.0562691675438725,charmer,33,6,39
0.36740017500000377,2.242815377192997,chemist,427,188,615
0.49980997412280814,2.819968475877184,chicken,1204,264,1468
0.52955614035087,2.202191998245617,chief,12922,1421,14343
1.70036220482457,2.2586320004385865,chieftain,219,180,399
2.292865673245636,2.63899880219299,child,10686,22791,33477
-0.05014090263157378,2.5064413543859576,choreographer,343,68,411
-0.45126806622807614,2.8071247377192936,chum,50,12,62
0.5303738802631681,2.0245643763157677,citizen,1644,4207,5851
2.1320797131579,2.09201341666669,claimant,322,157,479
1.5199823855262995,2.307938469736847,class,22588,3889,26477
1.9940867736842254,2.246400943421065,classmate,285,358,643
1.0831642780701856,2.4875859250000083,client,849,738,1587
0.7863137438596493,2.602211685087715,clone,530,430,960
-0.1855634855263144,2.2236312692982487,closer,3303,30,3333
1.6440143877192828,2.308718880263168,coder,5,8,13
-0.10632996666668504,2.49298837675439,collector,1208,673,1881
-0.06985052807019443,1.7861285328947218,combatant,110,295,405
-0.584118464473681,2.0300840644736624,comer,60,26,86
2.0242612157894744,2.0507215377193067,commander,11359,1979,13338
2.049473005701765,2.746145817543857,commentator,705,1446,2151
-0.0780421618420899,2.4091958916666716,commoner,103,226,329
-0.20226296578950098,2.2462029890350994,companion,1945,908,2853
1.112806436403515,1.3238567223684328,competition,8431,1677,10108
2.30250629473686,2.5776629179824386,competitor,670,1164,1834
0.3838831820175539,2.123008253947379,computer,6158,1189,7347
1.2441526657894713,2.2154660065789464,comrade,138,420,558
1.825943492105269,2.5674216109649155,confessor,201,12,213
-2.241847807017571,2.8291244100877115,conservative,3913,1056,4969
-2.27658390570174,3.0034942135964897,consumer,1085,700,1785
-1.6373402057017419,2.378331665350874,contemporary,7271,1034,8305
1.1011212692982486,2.5341426539473666,contender,690,440,1130
2.1644554622806975,2.7143548276315936,contestant,600,631,1231
1.1568030991228238,2.284952715789487,contractor,517,456,973
2.000065986403511,2.395396012719278,controller,1077,450,1527
-0.7115507885965062,3.182318325438594,coon,178,31,209
0.0624587377193091,3.490249314912271,copycat,47,4,51
1.465084835964916,2.46021824517544,correspondent,740,161,901
0.5312999894736805,2.1162567894736934,cottager,4,12,16
1.3724322557017423,2.2186517456140145,counter,3737,237,3974
0.814848402631565,2.3724761070175635,courier,460,52,512
0.7925636592105167,2.153337041228067,cousin,2123,509,2632
0.01833226666666654,2.837821564473691,coward,412,47,459
0.27643761535086675,2.906506085964919,cowboy,511,523,1034
0.4820371473684215,3.268177880701769,crab,499,351,850
-0.58297336798244,1.9589358013157998,craftsman,132,259,391
1.220931481140358,2.43665599956139,crawler,42,21,63
1.5321552267543819,2.6746534868420984,creator,2950,871,3821
1.9510761872806786,1.8890978657894753,creature,1566,1534,3100
1.287726578508785,2.491398181140351,creditor,49,282,331
1.027881531578954,1.93520858859649,creeper,61,18,79
-0.5280265565789435,2.852933141228082,crusader,424,719,1143
-1.0387092114035106,2.8504113973684255,cultist,4,22,26
2.4199737232456044,2.5056535614035074,dancer,921,1857,2778
-0.8772874092105312,2.282324126754393,darling,422,8,430
2.095718394736842,2.4695169127192855,debater,31,12,43
2.8348029495614195,2.6608738223684316,debtor,50,156,206
0.21338235087718793,2.909423605701763,decoder,16,4,20
2.1435793539473824,2.5340085600877327,defender,1208,1711,2919
-0.9867828078947323,2.7092899258771865,deist,23,23,46
0.1843041701754462,2.6539591219298106,democrat,1048,2107,3155
1.7148256635964927,2.083706630701741,demon,1286,830,2116
-0.1878990570175425,2.5284129096491164,denier,26,74,100
-0.200694364912275,2.5825852947368375,descendant,584,1249,1833
-0.3007863706140448,2.450604095175448,descendent,53,64,117
0.3477384245614026,3.0666598872806965,deserter,44,163,207
1.7820265337719334,2.37966890350879,designer,3003,1167,4170
1.14929592807019,2.24859660789474,destroyer,2451,2839,5290
0.9063699736842299,2.6401346771929664,developer,1287,2254,3541
0.801820963157887,2.1407430723684246,devotee,164,289,453
2.234396298684212,3.3702534499999928,dictator,558,69,627
2.3005276271929915,2.669374917543852,director,16935,2898,19833
1.4169272499999952,2.7292991184210518,disciple,228,397,625
-0.04379183464913261,2.640625971929829,discoverer,126,90,216
0.25004056535087216,2.2947620947368534,dissenter,42,264,306
0.6775909653508929,2.6347801885965065,distributor,538,299,837
3.4761713320175414,2.6313023048245583,diver,402,582,984
0.7003074947368386,2.64613294254387,divider,38,18,56
-0.01451954692983115,2.7018640592105374,doer,8,11,19
1.661751455263163,2.065627778070178,doubter,3,20,23
1.3831901671052655,1.6064612210526388,drawer,85,25,110
1.7817104868420959,2.337153490350886,dreamer,189,102,291
0.5099776184210523,1.7975117793859745,dresser,116,15,131
2.149767517543866,2.0569618355263284,driver,3170,2734,5904
-0.9487008640350858,2.486827450438584,dropout,122,15,137
-0.15151493289474516,2.8180543460526426,dupe,16,5,21
1.8717968008771972,2.3984064820175455,dwarf,1530,191,1721
0.5574637828947484,2.139644003947355,dweller,49,146,195
1.9411693052631627,2.109564684649122,elder,2150,349,2499
2.0000317500000087,2.4486077179824655,emir,290,77,367
0.04351576403508162,2.292054219298249,employee,1165,3109,4274
1.951487768421039,2.9717696881579005,employer,701,562,1263
0.648264462280709,2.4596024894736868,enemy,7687,3948,11635
1.7499685592105436,1.7510768114034985,engine,7650,4212,11862
0.3927483464912225,2.5192138293859614,engineer,4249,2635,6884
0.7554828605263086,2.44625792675439,enrollee,3,7,10
2.149528029824575,2.4049027105262972,entertainer,392,198,590
-1.0869089324561347,2.8756295385964936,equal,3697,361,4058
-1.2603880065789532,2.5085297850877186,ewe,73,102,175
1.7056908570175526,2.4292837776315714,exchanger,18,24,42
0.8507593416666577,2.684489339473668,executioner,139,52,191
1.6496194750000015,2.6542588412280708,experimenter,47,34,81
-0.15312271578946124,2.3277637267543945,expert,1548,1285,2833
0.45582679210525967,3.0929006864035404,explorer,919,491,1410
1.6129831561403396,0.838280660526312,face,10404,2002,12406
0.6534837175438533,3.0806439557017473,failure,5572,776,6348
1.2883418802631628,1.977948842543853,family,35185,5277,40462
0.3198542245614018,2.3538413675438683,fan,5086,10304,15390
1.8915800039473893,2.690465571929847,farmer,1513,1784,3297
1.989352139035086,2.7288152078947405,father,22373,728,23101
-1.2288748947368404,1.7794960921052567,fauna,657,37,694
-1.82489455570175,2.2859089017544,favorite,3764,451,4215
-1.0716426478070105,2.5518281421052667,federalist,332,206,538
0.285734340789471,2.1349564399122727,fella,49,20,69
2.0328253394736837,1.9705957118421047,fellow,6041,492,6533
1.2256095447368374,3.2063681043859678,female,12596,4552,17148
2.1500077302631464,2.268451980701766,fencer,41,8,49
0.7998757324561439,2.713690239912273,fiddler,69,31,100
0.6403921293859725,2.5093155978070207,fighter,5058,3343,8401
2.216882053070197,2.325662413596488,figure,7057,6255,13312
0.5601676008771896,2.7295625254386024,finder,123,40,163
1.5321387964912088,2.4051253679824622,finisher,218,162,380
-0.03776865000000207,1.6931073736842013,flake,50,80,130
0.46927789122807084,2.9032856969298315,flatmate,20,10,30
1.6366784320175274,2.699146557017551,flier,38,84,122
-1.218194493421045,1.8162733570175398,flora,883,18,901
2.0417015232456013,2.414628563596498,flyer,226,597,823
1.260690108771941,2.6961758964912317,foe,270,292,562
0.9828342070175449,2.3271949333333204,follower,240,1792,2032
1.6463556850877215,2.5310819320175444,fool,558,220,778
1.8828500372807007,2.4634098991228104,foreigner,132,542,674
-0.2708190885964896,2.741251532894715,forerunner,415,132,547
-0.6191825934210407,3.028029841666662,fox,8099,510,8609
-0.11715958991228348,2.5301203118421025,freelancer,63,18,81
1.7024460710526395,2.4311503978070235,friend,9824,10015,19839
-0.06157563859647652,2.611589730263143,frogman,5,19,24
0.9126539219298309,2.609987433771913,fucker,9,5,14
0.07674176885965878,3.06224545350876,fugitive,346,141,487
-1.5006232267543957,2.686591053947369,fuller,916,7,923
2.2668465675438583,3.1192856521929766,gambler,183,79,262
2.2024867618420902,2.2687191570175766,gatekeeper,94,14,108
0.2721773447368552,2.306220760964907,gatherer,53,118,171
-2.1904930197368433,3.2118589723684234,gay,4156,174,4330
-0.7039845013157997,2.8405160706140364,geek,285,60,345
-0.3234336855263127,2.735783506578942,genius,1206,75,1281
2.0923303192982434,2.7594649109649065,geologist,232,183,415
1.6384698083333387,2.2319072789473555,giant,4076,3129,7205
2.388167216666682,2.3430008324561378,girl,8590,5439,14029
1.811821829385961,2.390470825877207,girlfriend,1844,135,1979
1.3363061543859533,2.0017199811403437,giver,51,9,60
0.8300423407894755,3.0582400728070027,goat,456,327,783
1.2266426192982465,2.478353053508762,goon,52,38,90
-1.7650695934210567,2.6396636276315704,great,31055,109,31164
-1.0300404057017438,2.8049979311403437,grownup,5,8,13
0.6051501657894711,2.0987821649122935,grunt,86,103,189
0.16755911359649822,2.3003686956140434,guardian,3158,442,3600
-1.1359352846491362,2.1897845763157857,guerrilla,627,350,977
-0.07036481140350226,2.830938418421045,guide,4317,735,5052
-0.08023489166668263,3.5796304570175312,gull,180,169,349
1.1667913745614165,1.823900755701743,guru,332,97,429
-0.40772615482456054,2.489365925438575,gutter,56,40,96
-0.6098072872806934,2.8602559714912275,hacker,216,83,299
0.6843198877193082,1.962817002192967,hanger,51,35,86
0.10700768070173972,2.23225571710525,hater,31,58,89
0.4354367087719311,2.15100957719301,head,21431,4830,26261
1.817674083771939,1.7851969364035192,headman,34,23,57
1.8954844228070389,1.9583734429824418,healer,107,29,136
1.9486972043859616,2.0657088421052574,hearer,7,14,21
-1.3281991236842146,3.0069535412280626,heathen,173,82,255
-0.8500244429824608,2.4682640925438584,heavyweight,1820,25,1845
1.4415900030701838,2.4269749495614104,helper,298,120,418
2.585472368859639,2.9816217649122887,hero,5235,1872,7107
-1.8585962495614048,3.0911548552631736,heterosexual,280,24,304
0.010443909649142213,2.730480342982446,hobbyist,20,52,72
2.2512059087719116,2.2222977210526267,holder,707,609,1316
0.21326908552630996,2.550501148245621,holidaymaker,3,14,17
-1.7443909399122806,2.945949942543857,homosexual,727,287,1014
-0.6597788956140409,2.696446692982459,honey,1016,3,1019
-1.1920961355263255,2.5136079614035243,hopeful,260,26,286
-0.34414248684210946,2.2226968210526437,host,4855,2168,7023
-0.4572913631578839,2.4994767429824574,householder,118,43,161
0.9683614289473503,2.20042542631578,hugger,10,3,13
1.877516760526337,3.297503631140355,hulk,695,25,720
-2.0615024942982476,2.3510810938596425,humanist,232,24,256
-1.4340320096491297,2.728141019736828,humanitarian,705,6,711
-0.3386702938596535,2.723740021491217,humorist,48,13,61
1.084609429385985,2.157228867543868,hunter,2405,1345,3750
-0.024716583333333375,2.106142803508776,husbandman,24,12,36
-0.11580638947367206,2.87038814298246,hybrid,1404,491,1895
-1.2622164210526279,3.018372591228058,idealist,44,23,67
1.3558266140350863,2.0840853289473475,idiot,257,75,332
0.5816440798245495,1.9648385657894707,idler,24,11,35
-0.4513265078947164,3.1855228960526265,illusionist,29,4,33
0.4774848859649179,2.3692770789473627,imam,168,35,203
0.12827922017543258,2.4398206513157916,incarnation,560,200,760
-1.541565680263167,2.335595653508779,independent,9332,204,9536
0.023638679385978634,2.4116928412280743,individual,9095,5814,14909
-1.4880719592105187,2.9904526214912366,individualist,68,4,72
-1.1991473328947375,1.7700674771930025,inferior,883,10,893
1.9785250473684233,2.611212950000006,informant,197,95,292
-0.027422571929811568,2.5138010640350963,inhabitant,80,2425,2505
2.2609676570175417,3.8425466543859716,initiate,520,183,703
-0.6883771640350798,2.517782070614043,insurgent,136,505,641
-1.6847032504386021,2.595911081140347,intellectual,1618,375,1993
-1.5909275798245606,3.0930964929824665,internationalist,102,10,112
1.8069391346491166,2.322203946491216,interpreter,309,104,413
-1.2142050320175457,2.452247658333329,intimate,942,26,968
1.5945620153508742,2.3199656583333415,intruder,170,146,316
1.4211898271929932,2.1764042008771867,inventor,450,97,547
2.3469016877192956,2.4979530271929757,investigator,315,689,1004
-0.05035939868420769,2.723288576315772,investor,282,966,1248
-0.4894476043859779,2.6849279250000038,irregular,954,99,1053
-0.5650814583333315,2.471173531140348,islander,205,587,792
-1.190697037280696,2.759772148245615,isolationist,54,7,61
1.904160525877204,2.6980087688596512,jock,184,16,200
2.226861785087719,2.6380081675438536,judge,4872,1916,6788
2.5549194635964874,2.6944340232456216,jumper,233,105,338
-0.7609693513157989,2.5167549688596544,junior,4573,210,4783
-0.8046959118421242,2.009120242543874,jurist,112,80,192
-0.43337548859648045,3.1925103197368525,juvenile,1216,771,1987
0.8823951846491198,2.229928059649117,khan,2611,21,2632
2.159871242105261,2.4507736188596603,kid,1678,2277,3955
2.7163526807017586,3.064189336403535,kidnapper,51,73,124
1.320642335526312,2.3607964561403367,killer,2162,363,2525
1.5977230714912203,1.8074289236842063,knocker,19,6,25
1.9011859035087664,2.4173159846491075,lad,452,79,531
-0.20971924736842595,3.0456124609649127,lamb,1003,205,1208
0.6820141271929661,2.6982920701754534,lawmaker,21,116,137
1.562284633333336,1.7104342298245552,layman,67,100,167
2.3571284815789415,2.5093250850877187,leader,10593,6269,16862
0.04445519298245415,2.881122856140353,learner,34,55,89
-0.7573840947368442,2.407164013157903,leech,216,48,264
-0.18887123508772952,2.2263571464912353,lefty,76,18,94
-1.9745771061403392,2.863325375877203,lesbian,1155,315,1470
-1.2997986605263279,2.6024810109649312,liberal,3578,829,4407
-2.4194008627192947,3.3563583425438637,libertarian,345,44,389
-1.0111542802631597,2.6281794188596628,linguist,135,122,257
1.128780221491219,2.680150282456136,lion,2318,1555,3873
0.5119473789473599,2.6851736157894788,liquidator,14,3,17
2.301044990789487,2.6151887166666725,listener,493,910,1403
-1.3857146456140388,2.8857809039473583,logician,9,8,17
-1.4730261236842015,2.6427057144736867,loner,89,9,98
0.8698651394736867,1.8707204175438665,looker,7,4,11
0.85286289078946,2.086461193421048,lord,9878,2043,11921
1.446204207017562,3.11477416929824,loser,332,101,433
-0.5431243872806899,2.0224245149122755,lot,6579,982,7561
-0.4770975736842118,2.7204632320175293,lout,5,4,9
1.9447488662280783,2.320268264912272,lover,1724,878,2602
-0.5395040350877167,2.3546339583333307,lunatic,154,37,191
2.4634145837719412,2.3759443938596405,machine,7173,1647,8820
1.7299211517543878,2.852330407456133,magician,286,100,386
1.7549219947368382,2.6586193315789615,mailer,32,4,36
1.6022096258771708,2.690079372368425,maker,998,646,1644
1.1391581763157799,3.758328670175434,male,9170,4774,13944
1.9600051495614164,2.0670489495613857,man,30762,32879,63641
-0.6359655828947375,3.2052983280701692,marcher,83,105,188
0.5087210280701768,2.744745433771932,mascot,689,140,829
0.5137675157894854,2.0586354258771866,master,6147,1962,8109
0.7132056157894802,2.81985650570177,mate,1933,788,2721
-1.334413212719312,3.257089974561387,materialist,37,3,40
-0.2765889092105205,3.1382724574561482,mathematician,445,244,689
1.256383319298255,2.4912514184210526,mentor,879,86,965
1.0484171517543874,2.1728107280701856,mercenary,329,507,836
2.1932098048245585,2.2416828828947395,messenger,644,245,889
-1.2924976697368304,2.85185366403509,migrant,271,387,658
-0.7204673570175508,2.8824773412280695,millionaire,439,101,540
-0.6517136653508722,2.399512003508761,minor,9647,325,9972
-1.1630553048245549,2.3562994473684196,missionary,872,796,1668
0.638380316666666,2.506142195614043,model,8931,4412,13343
-0.06458014824562675,2.299766734649115,modeler,7,14,21
-0.4538093197368216,2.642834852193003,modifier,12,23,35
0.28728614429823907,2.5308929614034987,moneymaker,14,4,18
1.6941035504385908,2.3886795377193213,monster,2710,1545,4255
0.8146199013157869,2.7661736192982556,moron,20,10,30
-1.2747564907894997,1.980731783771926,mortal,1050,66,1116
-0.6661528065789337,2.7713434855263017,mountaineer,132,278,410
1.7587179947368323,3.1513642951754335,mouse,1447,563,2010
1.613424895175429,2.3097321385964804,mover,97,45,142
2.3892062679824537,2.603161934210531,murderer,536,180,716
0.005126711403519835,2.8355867122806835,mutant,417,209,626
-0.6009126995614107,2.141806045175443,mute,191,17,208
-0.4679745030701721,2.7679239021929885,namesake,443,19,462
-1.6695068359649046,2.0005982631578814,national,45586,624,46210
-1.530891173684207,2.1603311964912173,nationalist,1439,581,2020
-0.9251015105263196,2.4006344833333255,native,8244,910,9154
-1.0282584855263277,2.372030895614051,natural,10166,82,10248
1.7666690557017546,2.49603025131578,navigator,307,77,384
-0.9437847921052729,2.7406405438596497,nazi,2747,791,3538
1.9568457723684158,2.189191308771907,neighbor,651,678,1329
-0.09566158333333874,2.965658836403499,neighbour,306,980,1286
-0.5371154942982397,2.5763705052631654,nerd,79,51,130
-0.1696855425438475,2.345905518859647,nestling,69,203,272
1.544428351754373,2.006233067543846,newsman,16,6,22
1.3022629679824416,2.305719651315785,novice,133,38,171
1.5681939122807034,2.8719606543859495,objector,28,44,72
0.2865088162280802,2.4949039855263173,observer,1706,1213,2919
-1.31569411578948,2.1339164486842126,occult,282,4,286
-0.9614261451754249,2.8421899600877154,occultist,64,28,92
-1.03185540614035,2.165316551315799,oddball,39,4,43
1.7551939438596396,2.6926208153508835,offender,149,200,349
-1.2253614657894722,2.3885614644736854,official,14224,7271,21495
-0.39088289692983125,3.1454376986842014,offspring,959,8,967
0.22041354429823912,1.9574095307017796,oiler,77,513,590
1.5803035793859674,2.917895826315794,opener,915,145,1060
2.3075465171052745,2.5091305267543937,operator,1272,950,2222
2.160518699999999,1.8548537087719392,opponent,2661,3149,5810
-1.2337218662280698,2.8939764442982483,opposite,3650,104,3754
0.030603900877199663,2.16722474342105,opposition,5996,33,6029
3.053383528947368,3.041694532456143,organism,612,1676,2288
0.22338733903509223,2.3345448434210674,originator,73,32,105
-0.6866497899122876,2.9385331381579185,orphan,293,228,521
-0.5798055447368338,2.4696033859649216,outdoorsman,13,4,17
1.64266048421055,2.618388379385971,outsider,288,219,507
1.84239711798247,1.9580994644736744,owner,4043,3208,7251
-1.1856369491228147,2.9214269385964933,pagan,1001,113,1114
-0.8967117236842022,2.1225107956140317,pal,393,79,472
-1.0244879214912341,2.4661879688596535,pansy,16,4,20
2.957187068859646,3.2274111622806974,parasite,480,689,1169
-0.9311677543859798,2.3230491960526454,parent,1965,7259,9224
-0.9947255596491207,2.6222008951754514,parliamentarian,225,228,453
-0.3026887543859651,3.0734502065789577,parrot,485,274,759
2.3045700618421083,2.6394761982456085,participant,503,1763,2266
-1.1981500631579038,2.3048369271929694,partisan,1034,924,1958
1.8943087798245486,2.407444585526294,partner,3356,1725,5081
0.9402889947368394,2.197768495614012,party,26195,4288,30483
0.1352767885964905,2.0482467688596486,pasha,580,8,588
1.1700164907894681,1.9312227385965173,passenger,3612,3795,7407
1.105664600438601,1.976541478070187,passer,272,66,338
2.3787429679824754,2.5558942065789516,patient,1587,2039,3626
-1.0689184232456128,2.081366707456139,patrician,91,102,193
-1.6943599925438306,2.8677514004385785,patriot,574,635,1209
0.7776213964912344,2.8209812210526177,payer,32,28,60
-0.9180467092105253,2.0605374473684144,pedestrian,581,236,817
0.16979885350878732,2.6772468245614274,peer,556,986,1542
-1.0762256105263202,2.9993034000000076,perfectionist,145,9,154
3.1008017513157853,2.6328383171052483,performer,1139,1440,2579
2.119222730263157,2.0863530451754375,person,11675,49224,60899
0.5794648258771904,2.762440004824567,personage,31,38,69
-1.3372522802631597,2.4713947614035074,pet,980,387,1367
2.4592964377192974,2.389799192982478,petitioner,56,66,122
0.11559764166664976,2.8599343912280535,philosopher,1071,527,1598
0.05110272280701089,2.9323882969298225,physicist,630,364,994
1.4028367399122779,2.6263637657894723,picker,36,35,71
2.3818438469298364,2.519849781140353,pitcher,1788,547,2335
1.6841145482456028,2.8991827907894567,planet,6078,2394,8472
1.7262109425438759,2.5991578456140445,planner,153,377,530
2.222421224122776,2.7476895973684172,plant,7415,5599,13014
-0.16755390131578807,2.5378985008771817,planter,112,105,217
-0.8981921903508692,2.439177643859656,plantsman,4,7,11
2.966464206578955,2.412488048684205,player,27922,20973,48895
-1.0845072679824472,2.0961029179824493,pleaser,25,3,28
0.598620146052637,3.4184143057017486,plotter,27,166,193
0.23081081140352744,2.8168523271929793,poisoner,18,7,25
-0.2433051315789605,2.168617053070191,politician,1622,1734,3356
1.7219738456140519,2.5326293723684046,possessor,44,12,56
1.1028565754385884,1.9792729245614122,poster,893,675,1568
0.08702826359648874,2.316938752192989,potentate,5,13,18
0.3745481942982458,2.330831710526308,powerhouse,224,22,246
0.3969198885964804,2.387322029824558,prayer,1689,515,2204
-0.432392820175453,2.9713188302631615,precursor,807,238,1045
-0.7151204912280704,2.0096913578947504,predecessor,2358,1121,3479
2.5185223456140413,2.494552749561395,presenter,374,82,456
0.018807096491222808,2.711333477192989,preserver,23,8,31
-1.1769643688596627,2.6845451627193064,primitive,1094,31,1125
1.786740185526325,2.4350573535087605,prisoner,2082,4335,6417
1.5943795973684374,2.231550864473679,processor,369,188,557
1.3440963991228223,2.9850820864035192,producer,10663,5972,16635
-1.2526613385964929,2.766355596491241,professional,9659,775,10434
0.07619518771930522,2.72992556447368,profiteer,4,8,12
2.3302485473684005,2.2686074850877205,programmer,376,275,651
-2.1242655872807035,3.010631037719298,progressive,1974,66,2040
0.9868733508771932,3.482935047368434,prophet,560,211,771
0.20887221578946225,3.2695943017543847,proponent,358,467,825
0.7874928877193046,2.8087151486842057,prospect,1495,695,2190
2.7159991934210392,3.477371014473677,protagonist,2821,726,3547
-1.3133542548245494,2.285469494736841,protectionist,83,16,99
1.094012978947358,2.281236642543867,protector,494,89,583
2.216897291228067,2.2699037153508748,protester,79,834,913
-1.4588238771929802,2.1291850127192937,psychic,426,13,439
-0.11483334210526408,2.6604461991228003,publicist,216,26,242
1.9596479451754458,2.121788910087721,puller,70,5,75
2.728863366666669,2.7869227890350796,punter,140,15,155
1.952955468859642,2.5818097758772023,pupil,643,1177,1820
-0.08276703289473986,3.186496854385963,puppet,757,391,1148
2.309533328508765,2.891754830263155,pursuer,34,129,163
-0.7475630530701789,2.5383731223684283,pussycat,98,10,108
0.6881423131578934,2.034116574999988,qualifier,295,178,473
0.13305614298247015,2.830239982017538,quarryman,7,121,128
1.8425404780701875,2.3849524614035094,queen,11098,1166,12264
-1.3301601241228003,2.608941421929824,radical,2099,337,2436
0.14699067061404136,1.9126698421052755,rafter,39,110,149
-0.3541124969298206,2.5946799644736736,ram,1117,524,1641
0.7412187986842085,2.2540718241228,rat,917,913,1830
-1.368335498245612,3.0317532807017535,rationalist,56,5,61
0.6035196469298221,2.6313993754385994,raver,26,3,29
0.05732849429825748,2.777305092105271,reader,1645,2530,4175
-0.9490775258771933,2.9155603745614,realist,175,20,195
2.175983023245598,2.517765417543856,receiver,1075,346,1421
1.052644197807025,2.754443948684207,recipient,942,539,1481
-0.42301438157893934,2.7401836912280793,reformer,262,373,635
-1.337694639473689,2.8428146057017365,reformist,152,26,178
1.424936322368426,2.101048926754384,regent,858,329,1187
-0.8831234828947352,2.2618231710526384,regular,10127,541,10668
-0.6578520947368443,2.4235734469298347,relative,3500,1927,5427
-0.9380168245613998,2.718097540789479,relict,45,6,51
0.3415664736842068,2.245542606578958,reliever,130,38,168
0.8840491631578793,2.108078932017536,renegade,168,60,228
0.47511246710526933,2.483558010526309,repeater,23,24,47
-0.15511575043858983,2.34305185263157,replacement,3695,469,4164
2.468471244298243,2.186458265789472,reporter,2158,960,3118
0.3442117399122804,2.3659506833333435,representative,3604,3665,7269
-1.9168106447368523,2.6768696649122905,republican,5703,1900,7603
2.0918096065789573,2.4414738302631793,rescuer,35,129,164
2.3721215820175576,2.6672237285087697,researcher,573,2025,2598
-0.3616209026315804,2.517554811842098,resident,2894,6817,9711
-0.6483939337719402,2.676956180701726,resister,7,31,38
1.1529507508771815,2.7174031021929714,respondent,74,285,359
2.322545235526304,2.7659942451754365,responder,19,53,72
0.013031176315800863,2.1790780302631507,retainer,72,113,185
0.020181207456127837,2.9010626881579,retiree,6,30,36
-0.9136896263157954,2.81953215087721,revolutionary,3007,415,3422
-1.0490287815789419,3.035057057456143,revolutionist,13,9,22
2.879896306140351,2.6876200456140253,rider,1748,2746,4494
1.2428082789473507,2.760242423245611,ringer,61,34,95
0.3857645504385907,2.5184017377193086,riser,34,15,49
-0.1946849657894827,2.4165564802631625,rival,3393,1796,5189
0.49949546315790805,2.042712150877197,rock,20733,2453,23186
-1.2820866289473685,2.932545371929832,romanticist,20,4,24
1.3219394456140279,2.8226579320175382,roommate,220,69,289
-0.2552415021929857,2.639542172368417,rounder,239,35,274
1.215217462719302,2.764039313157916,rover,243,1019,1262
1.972004156578926,1.5876895214912299,ruler,2020,1278,3298
-1.1183028491228235,3.0247414241228157,runaway,369,62,431
0.6526343956140419,3.109754475877189,runner,1782,1214,2996
0.5816580201754409,2.782352095175451,runt,25,3,28
1.5511472438596563,2.2800578087719146,rusher,124,44,168
1.5079336557017609,2.4702100232456274,sacrificer,4,3,7
-0.005645919298247648,2.4834536359649224,saint,7507,1553,9060
1.4480124701754402,2.159662282017557,salvager,4,6,10
-0.7882018631579015,2.800577750877185,samurai,255,4,259
0.6592494798245507,2.316121123245649,satellite,2778,536,3314
-1.2672749828947438,2.2535988407894667,savage,1243,89,1332
0.12586010307018114,2.4891871267543753,saver,22,14,36
1.3390664105263177,2.838187360964911,savior,197,18,215
1.4211326223684146,2.540624305701755,schemer,14,4,18
2.2864097771930023,2.7399906530701603,scholar,2260,3394,5654
1.097258035526318,2.5449222228069956,schoolmate,43,54,97
2.224794908333328,2.5708957894736777,scientist,1552,3121,4673
-0.8054350530701804,2.5411067789473734,scorpion,175,121,296
-0.7242657982456198,2.5342528179824484,scout,1937,1222,3159
1.6847265289473583,2.163699802631557,screamer,6,13,19
1.1023285447368707,2.1245629666666765,scrubber,7,7,14
1.250189847807027,2.698340211403508,searcher,25,49,74
-1.1141171328947337,2.231485705701763,secessionist,90,29,119
-1.4177571956140351,2.3131342710526415,secular,1092,3,1095
-1.4230897592105443,3.0096368074561415,secularist,9,7,16
1.168564524561429,2.2603026688596657,seeker,96,196,292
1.6197598070175552,2.79469534035087,seer,72,13,85
0.2819356644736821,2.2455983390350944,selector,111,417,528
-1.4455184776315964,2.393410500877188,self,10629,83,10712
2.1554056732455926,2.356170003947364,sender,40,11,51
-1.0487148416666674,2.7604307820175435,senior,6947,291,7238
1.7861612767543988,1.8964216921052515,servant,932,1108,2040
1.0370318758771901,1.9491280815789533,shaker,89,36,125
0.43010503508772224,3.229772528070166,shark,3428,2071,5499
0.19125754649121163,2.1952388320175444,sheikh,311,55,366
2.7728620552631664,2.2835760061403487,shooter,949,311,1260
0.8588661043859691,2.5714791587719343,showman,80,12,92
0.6172101368421128,2.8975457438596592,shrimp,352,67,419
-0.2785826635964721,2.6454406921052644,sibling,242,1035,1277
-0.28827967982457103,2.6164230364035177,sidekick,199,33,232
1.0879323548245576,2.0028976864035055,signaller,15,43,58
2.2370974478070043,1.958669049561399,signer,38,121,159
-1.2248400903508845,2.685559864912296,sissy,18,3,21
1.1598851657894684,2.3334973403508705,sitter,144,33,177
-0.12091225657895066,1.7009876824561339,slave,2202,2469,4671
-0.9838958666666748,2.706120252192987,sleeper,244,101,345
0.5991288978070184,2.126324053947382,slider,124,28,152
0.6234987565789432,2.637261475438601,slinger,8,12,20
-0.8630547583333392,2.723738735526318,smith,11915,209,12124
2.2905121070175536,2.8853456447368497,snake,1742,725,2467
1.4359258710526195,2.267674766666664,snatcher,22,40,62
1.4670304214912289,2.6363955521929743,sorcerer,270,50,320
-0.2428096881578874,3.280062382017533,source,8045,6796,14841
0.449266606140343,2.4888262679824624,sovereign,1265,128,1393
1.3015569780701792,2.2210083925438706,spaceman,67,7,74
0.5909623127193004,2.361888139912274,spade,86,65,151
0.8432652807017487,2.7687106811403375,spearhead,131,42,173
-0.43109396491229823,2.5063985995614146,specialist,1207,385,1592
-0.05103817368420671,2.65976878070175,specifier,3,5,8
0.3678467201754554,2.0953436653508746,spectator,442,1348,1790
1.7121534320175549,2.7533057421052636,sphinx,61,8,69
-0.2537531719298247,2.87717119429826,splitter,45,13,58
0.09283419561404038,2.5830324837719374,spoiler,78,67,145
0.3468601451754374,2.976669037280695,sponge,263,274,537
0.0936500978070125,2.4330214802631644,sponsor,723,507,1230
0.3611984052631474,1.7873796008771894,sport,3920,7486,11406
0.7186383807017638,2.4461444109649157,spotter,78,53,131
1.0918077166666738,2.230945670614032,spouse,154,127,281
0.008755911842103004,2.1564952061403684,stakeholder,14,78,92
1.0314578337719382,2.835025197807008,star,22042,11432,33474
0.651537691228059,2.438071110526323,starter,928,237,1165
1.0980754355263116,2.2755387986842077,steward,350,201,551
2.0997432570175523,2.3995417276315685,stranger,707,303,1010
-0.18030804473683482,2.172310832456155,strikebreaker,3,27,30
2.3124108535087764,1.9672400359649114,striker,1037,273,1310
0.15148236929826453,2.6598336600877346,stringer,86,22,108
0.7307709307017554,2.2181881179824607,stripper,146,102,248
-0.25032967499999437,2.6831949925438625,student,7009,11675,18684
1.5184156618420985,2.3962682877192965,subject,8316,2649,10965
0.250287703947377,2.9563724491227923,substitute,1824,209,2033
-0.3244906258771909,2.54437339166666,successor,3119,590,3709
1.54297522017543,2.6911654394736626,sucker,150,71,221
2.326049394736847,2.61333972105262,sufferer,47,77,124
1.5248305657894825,2.2271445978070457,sultan,1768,71,1839
-0.6959235464912297,2.132169936842084,superior,3078,408,3486
-0.5812348934210583,2.3052897127192775,superman,1174,18,1192
-0.31810346754387986,2.322419339912276,superstar,488,287,775
0.1277185320175409,2.5743667377192896,supporter,1286,4151,5437
0.9171993894736747,2.7633937811403655,suppressor,39,11,50
1.1104435837719393,1.8431850671052672,surveyor,413,111,524
-0.7060975535087852,3.2001016241228175,survivalist,5,4,9
0.3799231828947409,2.8009562320175423,survivor,1246,2755,4001
2.012069950877205,2.58028356447368,suspect,1121,795,1916
1.2001646245614133,1.9789557254385937,sweater,156,45,201
-1.1854961482456066,2.359259208333329,sweetheart,241,36,277
2.739104010964928,2.7398496657894746,swimmer,508,319,827
1.2412829346491172,1.8585307890350933,swordsman,71,20,91
0.3993494135964717,1.9268482828947189,tactician,53,17,70
1.0926557381579034,2.471181057456123,tapper,29,4,33
0.8626741008771894,2.3170202236842066,tease,115,55,170
0.45679720921052613,2.612632014473677,teaser,488,43,531
2.072140594736842,2.103455653508771,technician,275,319,594
0.26863711754386266,2.0829054407894567,technocrat,5,8,13
-0.513228878508766,2.621478503508767,technologist,12,8,20
0.5515385171052696,2.202519743421064,teen,1277,435,1712
2.213942663596482,2.291304085087731,teenager,893,666,1559
0.5687218087719383,2.479200893421064,terror,1019,48,1067
-1.308108210526317,2.9752266438596457,terrorist,911,385,1296
-0.21858941929822429,2.9747967986841974,theorist,250,270,520
2.5556354456140227,2.7954287942982265,therapist,159,61,220
1.3900778333333381,2.5363152960526225,thinker,129,202,331
-0.7746031434210536,2.784811538157893,thoroughbred,319,119,438
1.8610810508772087,2.670524597806997,thrower,72,163,235
1.1660405921052597,2.337965182894738,tiger,1842,1700,3542
0.5378260995614035,2.183892426754385,tinker,300,11,311
-1.351750056140375,2.4969562175438647,tool,1291,1731,3022
0.22969280526316282,2.5918843706140304,topper,138,24,162
-1.2868713315789488,2.2213837245613846,tourist,1593,1453,3046
0.01636708991228808,1.9229343407894781,townsman,3,26,29
2.010367719298232,2.136569079385957,trainer,694,326,1020
0.606881805701752,2.094047938596482,transfer,4003,437,4440
0.9553512741228136,2.663304758771938,translator,340,110,450
1.6274792030701857,2.4194923592105173,transmitter,237,115,352
1.8798653662280618,2.0460675127193166,traveler,264,565,829
-0.40355318333332946,3.097451858771949,traveller,338,296,634
1.2685944241228118,2.5031292087719272,treasurer,664,19,683
0.6064409881578978,2.4123567956140484,trimmer,191,23,214
0.8122642921052581,2.4825710732456,troublemaker,49,21,70
0.7285042250000142,2.4768856925438563,trustee,438,1088,1526
-1.2783877565789545,2.4797513491228127,turner,2043,10,2053
-0.015145102631571206,2.40901039122806,twin,3171,1065,4236
2.2261237131578895,2.892943821491226,tyrant,321,108,429
-1.3687969122807093,2.433520851315766,unionist,175,134,309
2.2713468543859747,2.9128169394736894,user,1624,2111,3735
0.5636356122806916,2.3354869333333372,vacationer,3,18,21
0.06463757192980779,1.7748389285087551,vassal,359,179,538
-0.6499367478070255,2.2959221289473657,veteran,1797,1772,3569
1.841174811403496,2.4562275789473773,victim,1791,3195,4986
0.8396072473684217,2.9548729184210263,victor,2341,166,2507
3.1501463969298253,2.495165318421064,viewer,1001,7379,8380
2.1109770868421016,1.8340417092105028,villager,61,671,732
1.246378031578944,2.9832583346491095,villain,1466,866,2332
-0.2784946592105495,2.7977946684210426,virgin,2202,77,2279
-1.1284801350877096,2.384782144298237,visionary,215,11,226
1.1041553412280738,3.1286442956140483,visitor,1018,3227,4245
-0.43234940570175695,2.2898483574561386,volunteer,1614,2063,3677
-1.2230355144737004,2.6719026057017565,voyager,815,13,828
2.034464277631553,2.384417670175454,waiter,176,51,227
-0.5582358500000009,2.360076779824551,walker,2773,235,3008
0.08396054429823607,2.801348838596505,wanderer,101,815,916
-1.077477339035088,2.616020683771932,wannabe,103,16,119
1.555850571052627,1.732537031140346,warrior,1570,1986,3556
0.9033339074561244,2.3573055627192865,washer,32,10,42
1.9167133986842142,2.950604103947379,wasp,566,371,937
1.5218288061403449,2.1310327096491246,watcher,67,93,160
-0.4522571916666589,2.471094772807021,waterman,75,7,82
0.4510717162280713,2.123868080701765,waver,40,10,50
1.8649420175438625,2.3792730135964657,wearer,94,16,110
1.2304597039473677,2.9463748837719237,weasel,198,78,276
-0.772634607017558,2.797872007017544,westerner,27,114,141
-0.25106661754384874,3.8772386109649,whale,1677,1475,3152
0.026493776754371368,2.614940156140353,wimp,9,4,13
1.268981056578939,3.9241533907894706,winner,4292,1990,6282
0.7667875837719293,2.1837480390350823,wiper,3,17,20
1.5865851671052642,2.0009848960526266,witch,1227,594,1821
1.529293380701752,2.340811898684221,witness,1586,1783,3369
1.5671928614035249,1.8568664758771742,wizard,754,433,1187
2.1472965197368232,1.9256810039473677,woman,11305,21958,33263
2.3848221228070248,2.3762235605263147,worker,1509,6464,7973
0.6563306890350997,2.5869433649122815,workmate,4,4,8
0.0779355434210558,2.569687385087711,worshiper,9,56,65
-0.07901729517542933,2.592802023245609,worshipper,25,112,137
1.6513228381578937,2.122095077192986,wrestler,969,1096,2065
1.8375752087719182,2.69812356885965,writer,11195,8004,19199
2.2735156692982557,2.492224507017534,youngster,110,118,228
-1.1775014868421128,2.0456306333333387,youth,5056,301,5357
-0.9824224206140268,2.2553732201754375,zombie,601,342,943
-1.1715882214912199,2.1682335570175564,zooid,17,73,90
