ss,pp,sent,s_freq,p_freq,freq
4.259143196000117,4.926696294000074,abductor,998,1004,2002
3.1326423720000918,4.864094282000217,aborigine,354,2697,3051
4.232596215999898,4.858617809999878,abstainer,164,426,590
3.7401797100000564,4.402176816000079,accumulator,2194,469,2663
3.979286551999955,4.545597047999934,achiever,577,1612,2189
4.100784264000005,4.586716440000046,acquaintance,13178,9081,22259
4.602901620000104,4.796175664000053,actor,199773,143125,342898
4.5102767119999,4.766766760000152,actress,90150,12160,102310
4.396494033999957,5.210223068000076,addict,12455,18953,31408
3.6682738320001604,5.359460904000144,adherent,2216,12743,14959
4.283747067999961,4.696866397999884,administrator,61210,57008,118218
4.174064315999956,4.960392387999995,admirer,6444,6882,13326
3.6437348660000026,5.114001382000026,adolescent,26820,18675,45495
3.09301426200021,4.853424800000042,adult,245407,211316,456723
4.259744849999947,4.73651681199992,adventurer,6950,8770,15720
4.617991833999973,4.75059987999996,adversary,14726,15142,29868
4.11549664200021,5.038631555999949,advocate,129120,169090,298210
4.2589156940000805,4.952676842000109,agent,296265,259730,555995
3.971409612000045,4.8339615220002585,aggregator,5228,2317,7545
2.881993588000064,4.237879194000016,agonist,4617,3250,7867
2.9440351119999377,4.677089943999974,albino,4706,945,5651
3.8640446079999435,4.80015134399995,alien,134423,59864,194287
3.8001541960001077,3.960764666000017,allocator,2767,684,3451
3.4456875540000027,4.7195640239999435,amir,15694,147,15841
4.328655554000122,4.947021513999893,amputee,2353,1728,4081
4.136359403999926,4.699458930000041,analyst,140326,139030,279356
3.239245621999906,5.02883157600008,anarchist,44060,26033,70093
4.198305669999982,5.022951454000015,anatomist,758,396,1154
3.57141416999999,4.738195434000076,ancestor,16543,40028,56571
4.291607693999943,4.880222555999978,angel,71285,52496,123781
3.889262946000052,5.044574220000058,animal,376786,323086,699872
4.1707722479999205,4.742567495999893,animator,8445,7778,16223
4.099364444000045,4.833622856000041,antagonist,12276,6215,18491
3.1595852920000382,5.011581297999982,antiquarian,1833,197,2030
3.719031202000025,4.782421114000051,antiquary,125,240,365
4.1892950759999295,4.926279194000067,ape,11422,13950,25372
4.242729846000081,5.297363076000046,apologist,4324,8652,12976
3.7164848600000937,5.073021517999891,apostate,2730,2622,5352
4.154830086000132,4.605655338000091,applicant,21197,49503,70700
4.473310409999975,4.943860129999912,appointee,7152,11733,18885
3.3468009320000647,4.364081390000038,appointment,84329,30798,115127
4.161326360000004,4.591575676000019,arbiter,7407,2643,10050
4.234285780000064,4.66402994799995,archer,21385,4952,26337
4.476883999999977,4.8888711500001065,architect,56275,39639,95914
4.3566864239999745,5.033919122000107,aristocrat,2937,4228,7165
4.422003493999995,4.7282246840000255,artificer,1139,313,1452
4.501694783999973,4.706140982000065,artist,229336,212484,441820
3.4665756760000335,4.716523963999926,ascetic,3489,753,4242
3.9552726160000162,4.9961063000000365,aspirant,1909,1896,3805
4.1756180420000675,4.6572846840000395,assignee,421,164,585
4.107461554000011,4.7920514040000555,assistant,282156,21877,304033
3.6688718159999425,4.723752484000016,associate,161000,55860,216860
4.156836977999951,5.099190399999955,astronaut,28563,39886,68449
4.438899913999897,5.050838513999956,athlete,58866,116006,174872
4.010731973999938,4.471555584000022,attraction,52751,22535,75286
4.417336680000005,4.972123889999885,author,463215,225163,688378
4.176411768000023,4.840178329999915,authority,381264,501897,883161
4.463645212000017,4.442838375999997,automaton,3080,3462,6542
3.87373281600005,5.02357913000003,baby,297082,89352,386434
3.3850807899999964,4.486981975999974,balance,328654,26376,355030
4.208094012000032,5.106887530000037,banker,22058,45232,67290
3.80261809200001,5.06085218599987,barbarian,8538,5867,14405
4.409477554000027,4.964429640000027,beast,77081,21937,99018
3.317428679999992,4.402661615999946,beater,2111,1081,3192
3.672887162000073,4.005088997999984,beginner,14917,14870,29787
4.424037989999931,4.797640136000076,beholder,1326,155,1481
4.692977396000138,4.963602280000011,being,5830771,92990,5923761
4.639504620000096,5.2203441779999125,believer,23513,32466,55979
4.114785531999772,5.0684368960000015,billionaire,71829,22891,94720
4.51606868399989,5.032128813999911,biologist,26008,18230,44238
4.109842357999938,4.447051461999955,biter,532,306,838
2.328450368000013,4.323204851999996,bleacher,9033,3998,13031
4.085579213999992,4.7738103880000935,blogger,48537,30692,79229
3.939182938000009,4.414303361999991,boater,621,2345,2966
3.985660780000053,4.794711845999963,boatman,702,526,1228
4.013776164000049,5.030131645999816,body,1036949,241587,1278536
4.044647158000032,4.622112616000145,bodybuilder,2626,2937,5563
3.927134430000116,4.811115965999974,bomber,44275,38056,82331
3.8273331339999785,4.802136475999951,bondsman,553,446,999
4.00774282199999,3.8222674559999206,bookmaker,1363,2639,4002
3.2283918679999957,5.238791403999997,boomer,6703,15065,21768
3.2569505679999295,4.644130685999961,booster,26185,10990,37175
3.9529209879999527,4.220598471999985,boss,180377,48969,229346
4.178792057999885,4.67630899400006,bowman,15464,254,15718
4.41575586600004,4.827990669999927,boy,344870,247922,592792
4.516780628000056,4.568505220000134,broadcaster,35350,20661,56011
3.762544987999995,4.862438056000059,brother,269930,178543,448473
4.449340195999994,4.551260004000092,brunette,5020,294,5314
3.4229713560000192,4.7164051060000105,buddy,39376,17096,56472
2.892042102000012,3.8228185919999618,buff,22085,12139,34224
4.128716338000011,4.806178572000178,builder,27762,25069,52831
4.018026975999938,4.272220871999927,bull,79088,72714,151802
4.335408894000132,4.756899315999959,bullfighter,442,157,599
4.267617613999917,4.611426479999963,businessperson,803,3522,4325
4.119933514000088,4.941308604000028,busker,699,641,1340
3.0725175019999824,3.9277682119999895,buster,11618,2333,13951
4.2355284079999365,4.684051900000107,candidate,506899,347570,854469
3.805381334000046,5.348947205999892,capitalist,88834,20133,108967
3.9963446339998683,4.3626888600000555,captain,253483,16668,270151
3.3719174059999943,5.2163544460000395,captive,29473,7587,37060
4.452268060000158,5.067278901999998,captor,1436,5759,7195
3.829771596000043,4.779627615999921,carrier,98127,59639,157766
4.113672091999938,4.4937872579999905,cashier,7243,2111,9354
3.767081840000145,4.878916814000021,castaway,1763,1674,3437
3.1798564420000375,4.1702472380000515,category,169959,93878,263837
3.8594631840000915,4.530293683999972,caveman,2778,1174,3952
4.317514004000074,5.015030570000107,celebrant,799,1211,2010
4.1997645640000485,4.7670520479999325,challenger,40310,14137,54447
3.6755267920000705,4.3698025020000415,champion,203122,176920,380042
3.9700788659998025,4.195112700000145,changer,7475,2584,10059
4.146507860000121,4.870311216000154,character,690363,486749,1177112
4.010641003999929,4.438274534000058,charmer,1023,292,1315
3.7982904420000665,4.795160884000104,cheerleader,7129,7446,14575
3.432639495999865,4.706506856000146,chicken,149491,26550,176041
3.734356924000082,4.690868326000178,chief,930238,83614,1013852
4.224529932000102,4.738543702000037,chieftain,3107,1644,4751
4.422312740000066,4.9884764320000485,child,741674,1313110,2054784
4.693460533999975,4.825571710000112,choreographer,2818,642,3460
3.3858090820000726,4.87102174799989,chum,2631,1083,3714
3.993790178000026,4.8320088480001,citizen,148173,424169,572342
4.274702550000022,4.97299039,claimant,5792,11538,17330
3.5418262919998824,4.543783073999947,class,913518,202635,1116153
4.161649656000158,4.591424281999949,classmate,11363,21505,32868
4.138222683999928,4.444369458000033,client,217687,162342,380029
4.088261393999979,4.787138308000138,climatologist,2607,1710,4317
3.240334816000022,4.668796121999897,clone,43670,14859,58529
3.8658843740000464,4.718307499999938,coder,3689,5606,9295
3.995635440000008,4.23991643800008,collector,30236,26981,57217
3.2581985540000176,4.534997381999943,comer,3027,1884,4911
4.387942493999965,4.748649753999963,commander,156018,42244,198262
4.431763775999997,5.192805978000024,commentator,34298,43224,77522
3.4968345239999863,4.609273785999932,commoner,1658,2323,3981
4.509213987999971,4.574871418000036,communicator,3732,1930,5662
3.302399944000136,4.761755260000015,companion,58412,22314,80726
3.8478257140000522,4.7281807179998765,compatriot,3854,5766,9620
3.688405735999943,4.199393045999969,competition,333569,30010,363579
3.926460567999939,4.651615303999954,competitor,38460,70055,108515
4.31518839199984,4.900892415999948,computer,562607,147007,709614
4.125690097999879,4.8020719920000445,comrade,11084,21797,32881
4.61455732799994,4.880537574000073,confessor,1359,345,1704
4.148637078000064,4.657242298,confidant,5843,1721,7564
3.0137878299998846,4.79616479600007,congener,131,343,474
2.7806789440001154,5.0262017839999515,conservative,585591,202174,787765
4.297438798000009,4.724033421999955,conservator,1620,1052,2672
4.04922687000002,4.6756717620000785,consumer,297398,260356,557754
2.2063403239999033,4.162985937999885,contemporary,152691,9638,162329
3.9338573540000397,4.932759761999925,contender,41063,30134,71197
4.2484841979999715,4.941285634000003,contestant,14077,19782,33859
4.433167256000026,4.778674735999935,contractor,51364,57007,108371
4.002234432000044,4.5018367619998045,controller,96056,37150,133206
3.5395207020000115,4.229144184000049,coon,3524,3142,6666
3.1983976340000595,4.3868074520000135,copycat,5793,1331,7124
3.8909083579999972,5.0595905680001465,cosmonaut,3588,2930,6518
3.9952250680001242,5.060748235999974,cottager,50,492,542
3.038374312000066,4.218202245999876,counter,183062,23621,206683
4.1359868599999885,4.876163345999927,cousin,49538,40521,90059
3.5798593219999972,5.053637793999918,crab,18863,8318,27181
4.106542373999972,5.020882979999925,craftsman,4117,4467,8584
3.975736111999936,4.8448646140000164,crawler,4268,2353,6621
4.109011619999933,4.810746848000029,creator,102790,75996,178786
4.782870220000035,4.931307891999921,creature,108032,110048,218080
4.432545960000105,4.847688369999986,creditor,5230,21247,26477
3.902486543999963,4.611615139999984,cripple,10583,1534,12117
3.395984448000057,4.921505567999894,crony,8187,6419,14606
3.079932461999931,4.740329581999916,crossbreed,466,137,603
3.6036948700000266,4.882294645999956,crusader,12713,10185,22898
3.7597391620000877,4.831754226000001,cultist,1507,2684,4191
4.458138231999918,5.26591037999988,dancer,15972,17784,33756
4.42325007000008,4.914822819999969,debater,1370,1468,2838
4.481866608000026,4.752925115999879,defender,117539,86322,203861
3.046792294000042,4.693408516000062,deist,675,476,1151
4.159719583999987,5.027868588000118,demigod,1481,711,2192
4.07277849999997,4.737442112000103,demon,40968,30127,71095
3.6136427500000323,5.222718766000156,denier,4148,7311,11459
3.973980359999885,5.068317022000073,denizen,1204,6409,7613
3.814392993999938,5.160496635999962,descendant,10774,30422,41196
3.6056309679999075,4.903099943999933,descendent,2026,2185,4211
3.8130180419999107,4.854049868000118,deserter,1184,1974,3158
4.338076031999982,4.864111546000004,designer,117125,79755,196880
4.23634252599998,4.499617396000048,developer,220575,332059,552634
4.339543521999957,5.091207356000041,devotee,3495,8903,12398
4.548794274000002,4.984407691999856,dictator,31781,10532,42313
2.594795248000011,4.589073312000039,diploid,1343,49,1392
4.633810200000049,4.55694759,director,1075374,90402,1165776
4.531713562000078,4.98647193999998,disciple,8693,15346,24039
4.263740979999994,4.735194712000016,discoverer,2175,959,3134
4.287253937999971,4.963172912000054,dissenter,1161,5676,6837
4.085323355999968,4.435794357999967,distributor,18499,19609,38108
3.866371368000017,4.4924815800001525,diver,9079,15982,25061
3.413020702000061,4.606107362000131,divider,2823,1424,4247
3.875395262000019,4.381669525999918,doer,1249,966,2215
3.652220951999972,4.897978807999905,doubter,421,5095,5516
4.545992153999968,4.720495838000019,dreamer,4988,8658,13646
3.664031043999927,3.7814373319998396,dresser,3907,673,4580
4.313370770000134,4.559665001999875,dribbler,548,180,728
4.142003041999942,4.642253991999965,driver,331017,250280,581297
2.7976508979999295,4.546434324000053,dropout,7558,3230,10788
3.431940467999901,4.697338549999891,dupe,3183,1850,5033
4.154631682000094,4.932964075999976,dwarf,36582,8124,44706
4.321005269999901,5.101031382000102,dweller,2203,8112,10315
3.243906329999895,4.908022764000037,dynast,162,168,330
3.6310546780000337,4.8957325719999645,elder,73271,24336,97607
4.095280653999971,4.784952512000039,emcee,2590,827,3417
4.018519615999999,4.720317138000048,emir,6569,602,7171
4.249594896000005,4.90881596599997,employee,200643,435134,635777
4.312785979999923,4.531492868000015,employer,69758,113415,183173
3.641400940000061,4.787497475999942,endorser,887,910,1797
3.769956748000027,4.6464021799999955,enemy,258760,159377,418137
3.68074127000002,4.654294400000083,engine,306340,90589,396929
4.287787806000118,4.77947477000005,engineer,122504,134789,257293
4.093366621999991,4.718314157999863,enrollee,1408,6384,7792
4.382272936000071,4.62634536599986,entertainer,6554,5577,12131
1.993968143999922,2.9017335940000635,equal,301687,32146,333833
4.046710988000044,4.536867421999894,estimator,1851,812,2663
3.7716855800000957,5.080794526000098,eukaryote,343,1452,1795
3.993348568000002,4.355154694000035,exchanger,1553,879,2432
4.281479168000089,4.676613234000165,executioner,4454,1712,6166
4.4052069219999765,4.808508683999989,executor,3148,1341,4489
4.312058933999978,4.792173874000021,experimenter,4456,3031,7487
3.4028748020000705,4.695566674000098,expert,230712,352516,583228
4.172867412000002,4.889486882000071,explorer,45025,14386,59411
4.036807019999905,4.780707171999907,exterminator,867,416,1283
3.1596979059999626,5.115217270000002,extremist,63574,44445,108019
3.571958620000032,4.876338800000028,face,1141842,268846,1410688
3.1764739240000424,4.627891667999975,failure,319477,64079,383556
3.526710049999913,4.80997483600008,family,1698371,468573,2166944
3.393515324000063,4.6633251259999895,fan,390877,819281,1210158
4.276735735999985,4.96162494,farmer,55493,170886,226379
3.268352298000032,4.551266087999863,fastener,1008,1482,2490
4.3867689080000645,4.56890708800006,father,560727,57378,618105
2.8912531099999086,4.203591940000123,favorite,566791,39200,605991
3.0616589820000115,4.879451423999932,federalist,10773,1911,12684
3.9299883140001697,4.762055659999973,fella,3341,2032,5373
4.210405100000081,4.949898676000011,fellow,403431,11927,415358
3.190262346000033,5.115385264000089,female,530753,68014,598767
4.523994177999981,4.770406977999926,fencer,2674,1738,4412
2.608405554000015,5.016746678000125,feudatory,49,48,97
4.397019173999929,4.939212440000055,fighter,161699,199203,360902
4.237489487999973,4.798456836000021,figure,760376,348399,1108775
4.426133099999873,4.941079494000078,financier,7841,7358,15199
3.6733944799999065,3.5299665079999727,finder,9627,1779,11406
3.438414719999976,4.599670732000028,finisher,7080,4879,11959
4.168594973999937,4.787393873999704,flatmate,794,544,1338
3.892785449999927,4.95127743400009,flier,6759,9655,16414
4.020792138000068,4.672277946000072,flyer,16207,40549,56756
4.341974983999982,4.8576908919999795,foe,16945,21576,38521
3.913794648000078,4.866283083999903,follower,14780,106645,121425
4.444706977999928,4.955612254000066,fool,42080,15039,57119
4.24176583400007,4.9646105140000145,foreigner,10236,48499,58735
3.3004218720000793,4.496958543999931,forerunner,6863,2052,8915
4.3567509440000975,4.929250232000008,freelancer,5327,6525,11852
4.188668117999974,4.488962833999857,friend,541766,796235,1338001
4.177460369999842,4.319830286000013,frogman,280,300,580
4.305459882000022,4.779258950000006,fucker,1628,1415,3043
4.307683912000087,4.67590138399995,gambler,3822,5009,8831
4.098767703999975,4.815741477999886,gatekeeper,4921,5440,10361
2.4247152259998828,4.6146890299999725,gay,422991,33016,456007
4.4393258299999445,5.009566344000042,genealogist,458,369,827
3.0043191039999613,5.178561493999972,gentile,5383,3576,8959
4.232241915999971,4.445496822000024,geographer,2438,1059,3497
4.24323066800001,4.90259750000002,geologist,7670,6851,14521
2.9687617040000447,4.780835471999872,giant,323138,137928,461066
4.4102821620000014,4.742888115999975,girl,421549,356727,778276
4.467587164000058,4.422749812000021,girlfriend,73703,8158,81861
4.298301322000107,4.5715433940000025,giver,3634,1963,5597
3.6722767059999697,4.9268815580000265,goat,28023,15779,43802
3.8917871199999823,4.6746779959999145,goon,3769,5611,9380
3.498692756000132,4.962204399999912,grownup,1128,1312,2440
4.062483524000122,4.617529522000041,guardian,142509,35886,178395
2.926868645999967,5.010833580000046,guerilla,6257,1046,7303
3.968060683999923,4.71859969399997,guide,288542,46739,335281
3.2102828799998733,3.809456194000063,gutter,5070,1861,6931
4.138643004000052,4.590746984000177,hacker,53067,77753,130820
3.4359317899999766,3.78164953000001,hanger,4473,2044,6517
3.8300593979999746,4.470872389999975,hater,2711,9670,12381
3.408352350000037,4.444897667999982,head,1389552,220981,1610533
4.2190446020000465,4.597940604000023,headman,489,158,647
4.049221816000006,5.1402031219999245,hearer,582,674,1256
3.1465878880000986,4.605128398000069,heathen,3771,1468,5239
3.328523129999958,5.175038747999956,hedonist,452,258,710
3.8509160200000068,4.63079402399994,helper,18222,8071,26293
4.156227753999886,4.803250319999989,hero,190739,136373,327112
3.8404530120001183,4.602100939999772,hobbyist,3975,4615,8590
4.255248938000037,4.295211404000035,holder,71229,57763,128992
4.179601296000023,4.809637518000002,holidaymaker,299,2009,2308
4.233906291999922,4.530791372000039,homeowner,15601,37775,53376
3.1824598499999155,4.841929942000036,homosexual,44888,16051,60939
4.565469393999905,5.011881597999988,horticulturist,359,181,540
3.848526258000028,4.64084237600008,host,454280,106233,560513
4.23684329799994,4.545915888000003,householder,2735,1649,4384
3.7639314620001514,4.472479459999981,hugger,466,363,829
3.6658196239999583,4.984067100000132,humanist,14279,3985,18264
4.565553078000008,4.83637683000002,humorist,1233,277,1510
3.7242301879999644,5.156562211999983,humpback,5221,1022,6243
4.266787251999986,4.6258276340000535,hunter,101381,42584,143965
4.160367183999895,4.581192495999858,husbandman,79,83,162
2.794901098000196,4.921379261999867,hybrid,94391,11371,105762
4.017221378000052,5.1010886779998685,idealist,3203,2080,5283
4.027488079999934,4.958000958000056,idiot,21041,13299,34340
3.6055964059999326,4.814301928000027,idler,712,308,1020
4.520259125999971,4.799857805999828,illusionist,982,282,1264
3.9214215399998977,5.008987672000039,imam,26463,6346,32809
4.155730675999912,5.186187434000026,imitator,409,1880,2289
2.5776831459999414,4.587864818000028,independent,576562,27512,604074
3.497032541999964,4.6321891479999735,individual,735597,492543,1228140
3.5064098779999924,5.1045828920000105,individualist,4331,1058,5389
4.474216404000117,4.838150696000056,informant,16362,9681,26043
4.105163306000037,4.780239398000035,initiator,2547,1247,3794
4.1386219980001115,4.855843033999882,instigator,2678,1448,4126
3.536426818000031,5.182226679999999,insurgent,19540,26709,46249
2.4940676840000364,5.302888174000017,intellectual,168356,22698,191054
4.154072066000026,5.081091042000075,interloper,1159,1148,2307
2.8320777300000586,5.050339031999968,internationalist,4415,900,5315
4.5113974759999,4.885158883999971,investigator,48561,196321,244882
3.9530240600000255,4.596456720000091,investor,74569,234503,309072
4.065634425999896,5.072165630000072,islander,5961,28312,34273
2.9461333700000267,4.860838387999863,isolationist,3955,596,4551
3.7563535279999414,4.757061430000022,jock,6240,1913,8153
4.269799903999953,4.705909248000097,judge,592105,144717,736822
4.565231530000084,4.969757320000191,jurist,3458,3323,6781
3.1305552940000325,5.043469525999953,juvenile,47332,10197,57529
3.678022038000023,4.369096475999989,khan,90579,3075,93654
4.540488583999981,4.940350251999909,kid,188924,557940,746864
4.173030333999968,4.693758283999955,kidnapper,1640,4212,5852
4.126183638000043,5.052586091999856,killer,112088,27958,140046
3.9470810019999405,4.667272483999987,kinsman,1206,773,1979
3.357124923999997,4.026404057999912,knocker,371,288,659
4.359235509999863,4.40920299600004,lawgiver,440,118,558
4.336471904000035,4.741374262000043,lawmaker,33866,211575,245441
3.805358135999903,4.444133451999754,layman,3379,1492,4871
4.201133493999976,4.60992618000013,layperson,1085,1586,2671
4.258262290000005,4.810906483999936,leader,762448,678185,1440633
3.714200117999873,5.090138356000047,leech,6040,2231,8271
3.3830960100000027,4.31981357999998,lefty,14605,6811,21416
2.877728344000161,4.732826095999947,lesbian,58344,18989,77333
3.1413780640000724,5.38682508400003,liberal,401555,136494,538049
3.417443659999911,5.128910976000014,libertarian,87027,28531,115558
3.499278660000229,5.0988223119999105,libertine,1260,569,1829
4.513851193999933,4.963808227999948,linguist,5220,5323,10543
3.8138417479999873,4.576160843999993,lion,52581,97033,149614
4.098977888,4.3912559680000385,liquidator,704,1129,1833
4.31222667000003,4.854332743999997,listener,21817,35683,57500
4.27466057400013,4.834295600000004,litigant,1055,2550,3605
4.205664060000011,4.883332983999935,logician,624,692,1316
4.038919532000172,4.840872807999993,logistician,120,174,294
4.193619509999962,4.16681841800014,looker,596,118,714
4.030125431999984,4.274633294000026,lord,237751,34623,272374
4.184050461999973,5.172478242000132,loser,19871,24029,43900
3.4770266080000383,5.0832520539999635,lot,2775567,360227,3135794
3.975571444000174,4.963066714000092,lout,400,349,749
4.297913607999988,4.676365954000083,lover,30166,36505,66671
3.5138160739999194,4.855936327999842,lunatic,8770,2652,11422
4.346349744000101,5.405126025999863,machine,382474,163748,546222
4.105987297999825,4.699265658000044,mailer,4892,2509,7401
3.819343522000011,4.46909847999995,maker,79167,84270,163437
3.640756316000008,4.884988634000116,male,443669,90666,534335
4.429591527999982,4.933248497999969,man,2058373,1477560,3535933
4.319151400000031,5.170272576000059,manipulator,3795,1858,5653
4.095334353999974,5.245949491999973,marcher,864,9530,10394
3.900312421999878,4.5974844059999995,master,263405,79403,342808
3.4600097640001124,4.317982507999929,mate,60970,20464,81434
3.630119499999978,4.940050658000118,materialist,4999,806,5805
4.213310121999982,4.739527634000197,mentor,36788,11416,48204
3.681933142000098,4.509586320000011,mercenary,14516,12564,27080
4.121302055999955,5.046577388000095,metallurgist,274,203,477
3.43799439200005,4.4030548739999205,midget,4102,721,4823
3.6137193020000424,5.351808635999966,migrant,56757,118605,175362
3.0195508999999703,5.246033286000063,militarist,1473,638,2111
2.641298946000134,5.144098682000056,millenarian,684,56,740
3.963404191999885,4.7517119079999475,millionaire,14951,12219,27170
4.082236991999963,4.749879200000002,mineralogist,205,50,255
2.8593668519999866,4.388607466000046,minor,273713,30644,304357
3.2080906360000654,5.0837515759999405,misfit,3680,6568,10248
3.9081661680001574,5.304979871999947,missionary,21192,16467,37659
3.809849645999904,4.585562284000005,model,800618,319129,1119747
3.9572480519999402,4.597620251999899,modeler,1193,1821,3014
3.308672801999897,5.331660708000008,moderationist,6,9,15
3.085117414000095,3.7510152219999213,modifier,14462,6303,20765
3.8306693199999557,4.244010956000018,moneymaker,955,281,1236
3.9720541139998673,4.715130691999995,monster,139425,74076,213501
4.038777811999999,4.910266366000094,moron,3656,3454,7110
3.144647450000143,4.951220503999977,mortal,34611,5028,39639
4.388908032000067,4.676435242000011,motorcyclist,3729,3308,7037
4.252454814000004,4.88719354800007,mountaineer,2238,3974,6212
3.909519354000075,4.989332502000018,mouse,106737,105286,212023
3.670461605999968,4.545603027999974,mover,5738,6198,11936
4.362233168000003,5.029357069999918,murderer,18445,12226,30671
4.189673975999909,5.097054184000008,musher,346,429,775
3.1731569839999736,4.956447375999822,mutant,28804,11040,39844
2.117009539999998,4.572728966000071,national,2686417,66786,2753203
3.0278501640000712,4.967721722,nationalist,71245,25989,97234
2.9731006879999313,5.098173243999888,native,367344,19769,387113
3.3690971560000804,4.579041525999926,naturist,2096,789,2885
4.2055588019999135,4.528394707999993,navigator,8245,2491,10736
4.225327548000088,4.8710088280001145,negotiator,11606,18663,30269
3.8406224260001025,4.850178086000007,neighbor,58872,97443,156315
3.8272453300000038,4.825543092000174,neighbour,19344,34003,53347
3.3819220300000055,4.631422465999989,nerd,18717,12080,30797
3.6196823700000564,5.110730707999956,nestling,1074,595,1669
4.632064121999932,4.625820362000056,newsman,1226,526,1752
4.099821710000221,5.184799877999858,nihilist,1490,751,2241
3.2741322059998694,5.308423772000026,nonconformist,751,255,1006
3.2643818920001237,4.782664163999861,nudist,3149,1128,4277
3.994775666000045,4.884541412000132,numismatist,257,248,505
4.104904102000042,5.021796440000074,objector,1500,2098,3598
4.147432337999987,4.692110809999875,observer,54918,73140,128058
3.9930666379999735,4.926942581999867,occultist,1324,875,2199
4.174346657999962,4.899637225999854,occupant,6825,15213,22038
4.372337431999895,5.089422829999926,occupier,2003,8418,10421
4.114180417999918,4.758259486000078,oceanographer,1999,690,2689
3.3199553800000245,4.663029506000065,oddball,5621,672,6293
4.355818438000085,4.904201788000009,offender,28947,47808,76755
3.085180135999998,4.868049801999923,official,1022849,1170063,2192912
3.832773159999867,4.556391553999987,oiler,1102,23280,24382
4.426289452000063,4.6366966260001234,operator,91301,91222,182523
4.177293891999916,4.396563264000029,opponent,176745,207959,384704
4.510614068000052,4.920666538000063,organism,18722,38223,56945
3.904128357999987,4.309474760000079,originator,3938,1812,5750
3.186173544000006,4.845810881999974,orphan,12912,7628,20540
3.6953619899998813,4.856273018000088,outcast,5159,2635,7794
4.313742834000074,4.736254186000082,outdoorsman,743,292,1035
4.051257836000097,4.898039754000102,outsider,21009,24531,45540
4.190050975999924,4.478479644000217,overlord,7333,4437,11770
4.285931919999861,4.664025141999986,owner,329155,309636,638791
3.3711391540000974,4.9984822739999615,pacifist,6077,1463,7540
3.592749061999953,4.450905139999996,pal,19389,10973,30362
4.385032755999937,4.993338431999803,palaeontologist,1164,980,2144
4.3567106239999305,5.0445400019999695,paleontologist,4025,4084,8109
2.996625956000031,4.644763356000091,pansy,988,299,1287
3.9305871659999525,5.162402894000039,parachutist,464,296,760
3.383397810000062,4.769969455999998,paraplegic,1175,328,1503
4.3234793519999855,5.037263894000098,parasite,14368,13015,27383
3.7209645519999697,4.694678425999797,parent,167159,605176,772335
4.077391530000035,4.508917012000083,parliamentarian,5506,8360,13866
4.487666284000035,4.846074672,parrot,11545,4788,16333
4.178559214000018,5.002204867999957,participant,43546,255180,298726
2.1034842959999622,4.935598196000086,partisan,74546,9746,84292
3.9200619539999053,4.838876931999984,partner,294528,213400,507928
3.8302425779999822,4.772283654000134,party,1679913,387168,2067081
3.624016572000123,5.083979792000065,passenger,117560,144367,261927
3.905331920000002,4.2364509200001095,passer,22013,3532,25545
4.698519879999914,4.983612404000041,patient,214098,448648,662746
3.392295470000036,4.802638565999999,patrician,1992,524,2516
4.103273963999769,4.370811287999892,payer,8917,4738,13655
3.4693968020000128,4.6493286240000415,pedestrian,44929,30149,75078
3.1031578780000686,4.26654828199996,peer,64685,59742,124427
4.0430595860000835,5.08892840399993,perfectionist,2644,654,3298
4.565153682000144,5.037275571999892,performer,26881,36524,63405
4.323172530000008,4.912328175999981,person,1285464,9341934,10627398
4.443199649999848,4.993467865999953,personage,1032,892,1924
3.8480941479999373,4.4155706679999795,personification,4186,471,4657
3.453935854000008,4.58413770599995,pet,107029,37318,144347
4.359813617999983,4.865495676000087,philosopher,36863,29693,66556
4.292554860000017,4.9186443080000615,physicist,27884,23343,51227
3.5454622940001386,4.397501476000052,picker,4337,2498,6835
4.16219999599992,4.3083263700000245,pitcher,63997,41173,105170
3.9205935920000243,4.7437568599999835,planet,242895,69186,312081
4.290452752000128,5.086159565999928,planner,15635,26112,41747
3.9944678799999664,4.931134810000017,plant,341368,238723,580091
3.5664170019999446,4.384901081999921,planter,3121,3766,6887
4.038197877999927,5.0523630019999715,plantsman,13,1,14
4.345088235999931,4.727154029999959,player,1194193,1628482,2822675
4.031316606000033,4.970866734000175,pleaser,548,183,731
2.9128283020001433,5.1637371739999764,plebeian,978,444,1422
4.085448484000011,4.770621174000084,plotter,1030,3492,4522
4.107983460000028,4.64228744399999,poisoner,330,218,548
4.123729824000037,4.963611371999875,politician,85261,277559,362820
2.842528252000065,4.454405335999972,polyploid,207,78,285
4.444294785999929,4.765269848000045,possessor,1679,826,2505
3.7359319459999867,4.874169802000019,poster,78313,50297,128610
3.915714623999989,4.961258814000097,potentate,345,461,806
4.277697021999856,5.260107442000056,pragmatist,2078,1175,3253
3.298216463999971,4.495346709999936,prayer,91560,52708,144268
3.391298563999925,4.410345042000067,predecessor,32632,17158,49790
4.189624038000005,5.073825770000141,prisoner,54598,123489,178087
4.239918705999997,4.566093308000006,processor,69608,34350,103958
4.271189109999931,4.832858948000059,producer,174531,129671,304202
3.057074456000116,4.99029221199995,professional,473027,99041,572068
4.05375078599991,5.258535543999869,profiteer,651,1852,2503
4.241444953999967,4.761460182000178,programmer,33606,38023,71629
2.44140518800004,5.005808919999957,progressive,225347,36828,262175
3.6094521639999044,5.073856049999932,prokaryote,139,639,778
3.9012015960000426,5.574846460000202,propagandist,3413,4275,7688
3.92959044200002,4.986693488000114,propagator,445,362,807
4.391227694000108,4.974166362000034,prophet,63528,13896,77424
4.186477695999983,5.0323688460000255,proponent,18988,48141,67129
3.614665296000112,4.46342789800002,prospect,172517,108779,281296
4.567507074000034,4.911049983999959,protagonist,34384,12718,47102
2.8324783520000096,4.728123685999982,protectionist,8002,387,8389
4.088990058000078,5.073402297999877,protester,24545,230790,255335
4.3769377160001355,4.589803115999928,publicist,7827,1620,9447
4.121028528000011,4.798911921999917,pugilist,604,199,803
3.664854064000167,4.317822015999937,puller,1055,424,1479
4.218995577999962,4.558624099999982,punter,7839,4391,12230
4.138677463999933,5.1288886700000305,pupil,14328,30410,44738
4.105620173999938,4.656402001999972,pursuer,774,1324,2098
3.8135783439999003,4.6245339959999825,pussycat,921,366,1287
2.7758411479999836,4.85478403600014,pygmy,3611,1081,4692
3.1113446379999345,3.991559888000147,qualifier,22921,16741,39662
4.24730315999993,4.800296623999969,quarryman,47,194,241
4.284920749999905,4.739212782000031,queen,166245,44241,210486
2.565769457999977,5.219798307999959,radical,223315,20367,243682
2.815293940000039,4.579419111999869,rafter,766,3559,4325
3.611979763999983,4.812146443999964,rat,46030,57252,103282
4.058889321999779,4.794620056000085,rationalist,3321,1348,4669
3.469394129999955,4.7452537679999125,raver,552,763,1315
4.613783674000011,4.4857870620000995,reader,147724,242637,390361
4.079226220000038,4.9804416799999345,realist,6623,2829,9452
4.228637688000099,4.489351235999976,receiver,134662,52650,187312
4.357821427999838,5.1488064460000516,recipient,42592,44845,87437
3.6794919020000663,4.208363366000057,rectifier,838,211,1049
3.738697339999945,5.0687998020001785,recusant,74,45,119
2.432406267999987,4.080031259999998,referral,17288,8921,26209
4.207044447999898,5.11495193800009,reformer,4929,12259,17188
3.0371283720000193,4.9492967960001195,reformist,9514,2543,12057
4.152370972000085,4.581180911999972,regent,9097,9268,18365
4.400384611999904,4.481086334000061,registrant,2429,2355,4784
2.029378075999972,4.8112413420000735,regular,549196,11849,561045
2.194538010000052,4.775232236000022,relative,254163,84651,338814
2.4143149239999957,3.9327930340000847,relict,508,111,619
3.585562410000101,4.7203155159999355,renegade,10140,4109,14249
3.4501175120000553,4.40149196999986,repeater,2657,1060,3717
2.5414520379999743,4.742743429999997,replacement,143318,15227,158545
4.663158143999901,4.801272306000001,reporter,211728,263164,474892
4.036594506000128,4.7772944879999955,representative,228263,198721,426984
4.319067023999914,4.97654315399997,rescuer,1864,12757,14621
4.291267289999944,5.036610285999956,researcher,112724,586536,699260
3.890622030000017,4.946945737999947,resident,168263,452813,621076
4.034527602000104,4.905459082000142,resister,418,1559,1977
4.247632955999947,4.845252086000059,respondent,10520,91738,102258
3.373688877999953,4.622002222000063,retainer,2601,1285,3886
4.062158119999964,4.5585592000000545,revenant,3238,576,3814
2.777794875999888,5.203257429999908,revolutionary,152328,14010,166338
3.2772907599999783,5.149113494000055,revolutionist,354,428,782
4.377189386000154,4.96950953000006,rider,59330,89015,148345
3.9091044059999476,4.290882209999893,ringer,3878,796,4674
3.41349871999995,4.546520337999972,riser,2631,1671,4302
2.880781827999904,4.568734942000027,rival,145754,80130,225884
3.3602418259999425,4.839978364000061,rock,405818,77990,483808
3.6707601539998436,4.784537830000076,romanticist,156,55,211
3.0403607340000463,4.412406986000022,rounder,4276,1024,5300
4.468748729999888,4.844064232000022,ruler,29619,28332,57951
4.289558515999978,4.741611545999845,runner,56065,44130,100195
3.384065958000022,4.729691819999971,runt,1168,220,1388
4.253574808000053,4.911978324000053,sacrificer,48,23,71
4.28739733200004,4.854250078000085,saint,91005,82850,173855
3.9222129600000457,4.914571577999993,salvager,183,249,432
3.6321128260000677,4.625033125999998,salvor,110,90,200
3.570206536000086,5.038344502000136,satellite,155698,48295,203993
3.47222028399986,4.416493923999965,saver,5048,6053,11101
3.140716938000004,4.685682426000042,scab,1708,1427,3135
3.4915508479999673,5.07569589799995,scalawag,102,157,259
4.324649012000059,4.901612900000131,schemer,957,592,1549
4.218139454000024,4.731933035999951,scholar,98726,92386,191112
4.074504817999873,4.441414248000079,schoolfriend,141,109,250
4.3330017140000265,4.555561250000068,schoolmate,794,1297,2091
4.2550175120000375,5.096088747999993,scientist,137342,480352,617694
3.771349696000158,4.446550577999865,scorpion,9151,4417,13568
3.9051662200000266,4.553587089999951,scout,58697,49365,108062
3.929304907999999,4.2759503939999846,screamer,1129,447,1576
3.3382893399999674,4.264074119999982,scrubber,735,659,1394
4.000449374000098,4.73453947999991,searcher,1362,4092,5454
2.8104895900001594,4.642689207999865,secessionist,3825,1180,5005
3.151497436000014,5.291095504000133,secularist,2688,3366,6054
4.3962862419999595,4.751582825999925,seeker,14349,43675,58024
3.7734553400001403,3.898222588000131,seer,5043,1303,6346
3.7863305559999603,5.044087181999998,self,194672,7631,202303
3.3091983740001254,4.505953856000069,senior,697277,38826,736103
2.7613815519999463,4.769729655999981,separatist,23189,19388,42577
4.197604227999932,4.931310873999969,servant,28622,36695,65317
3.657545820000088,4.225468418000084,shaker,6143,2982,9125
3.9984089480000193,4.737636495999993,shark,59423,53805,113228
3.9891958240000207,4.577728252000085,shipowner,154,324,478
4.254173251999958,4.529128691999887,shooter,74637,28729,103366
4.307006048000019,4.112753046000073,showman,2326,253,2579
2.988070010000122,4.96124256600001,sibling,15055,32713,47768
4.250431205999988,4.417484118000068,signaller,198,145,343
3.6352305380001297,5.088755634000009,signatory,6274,11312,17586
4.074051166000032,4.601778179999933,signer,2372,3843,6215
4.168356518000046,4.724095561999917,sitter,2794,1094,3888
3.8896498699999356,5.19766450800001,slave,77530,57420,134950
3.8947067160000515,4.712188257999934,slinger,671,410,1081
3.955556351999931,4.529208627999971,smith,384577,4840,389417
4.2399619819998335,4.710094311999967,snake,53335,22641,75976
4.138798670000035,4.723117889999905,snowboarder,1465,1328,2793
3.4893571600000755,4.388432627999961,source,890627,469592,1360219
4.275583921999996,4.8025879300000085,southpaw,3860,562,4422
4.100064607999947,4.58021428800005,spaceman,880,507,1387
3.5177812119999032,4.010252323999914,spade,5482,3970,9452
3.4910148120000315,4.401431568000092,spearhead,6754,1048,7802
3.587704451999933,4.718717293999973,specialist,80426,36213,116639
3.2061424720000247,3.8648861340000664,specifier,832,467,1299
4.094358998000011,4.783902514000026,spectator,16339,21772,38111
3.876904497999945,4.674624756000007,speculator,1487,9186,10673
4.422608992000093,4.845536558000035,sphinx,5208,516,5724
3.5297482679999277,4.19633346399992,splitter,4739,775,5514
2.8519882279999464,3.9289025399999815,spoiler,30630,20296,50926
3.714034773999849,4.519302916000008,sponsor,65597,48205,113802
3.759505694000147,2.500440767999926,sport,216777,541162,757939
4.014961606000021,4.221563918000022,spotter,2500,1804,4304
4.208937634000087,4.813389501999957,spouse,28673,17571,46244
3.4858747840000532,4.878474406000024,star,832762,308789,1141551
3.2851829019999528,4.338837145999932,starter,85343,36256,121599
3.9396427060000505,4.642140056000066,stooge,1785,3452,5237
4.618542789999992,5.010771942000055,stranger,68755,41913,110668
3.5969586680000702,4.944547859999986,strikebreaker,49,459,508
4.470480300000084,4.911012297999974,striker,69432,18984,88416
3.709964710000037,4.6147786600000344,stringer,5289,610,5899
4.038892839999896,4.77150384200003,stripper,4903,3000,7903
3.980092077999977,5.185207320000018,student,633815,1072692,1706507
3.9555058519999946,4.689397631999924,subject,536422,145054,681476
3.2908446519999046,4.783738179999986,substitute,66352,11268,77620
3.0934965079999586,4.7513778760002054,successor,51431,9675,61106
4.427304183999844,4.803666473999954,sufferer,2950,9269,12219
3.7262841740000425,4.97706642,suffragist,554,679,1233
3.2179714739999596,4.548946122000089,superior,142577,11679,154256
3.8338122980000833,4.647975218000099,superman,53936,631,54567
2.6877181760001037,4.739351734000074,supernumerary,526,36,562
4.41847229199999,5.033956476000014,supplicant,541,424,965
3.9655562559998856,4.536370470000001,supporter,87759,395558,483317
3.3514263940001285,4.58594606400009,suppressor,3720,1854,5574
3.2760365820000743,5.160807240000189,supremacist,28433,16498,44931
3.9606660119999546,4.702930679999959,surveyor,4009,2572,6581
3.3257411259999543,4.635253823999946,survivalist,2191,786,2977
4.325061238000046,5.096088062000057,survivor,47669,77634,125303
4.338948409999965,4.694648515999994,suspect,265635,114292,379927
4.134565380000062,4.71700356799991,swimmer,8628,9263,17891
4.105620848000022,4.553502573999836,swordsman,2783,782,3565
4.091770768000082,5.0662790879997885,sympathizer,2118,6120,8238
3.1986574339999265,4.997528936000158,syndicalist,1840,683,2523
4.342185425999958,4.591002045999936,tactician,2485,597,3082
3.9114239300000833,4.611493119999992,tapper,10213,288,10501
4.479843147999965,4.910649776000042,technician,18692,18233,36925
4.203334711999958,5.404647697999977,technocrat,1427,2899,4326
4.335104331999915,5.0595150699999465,technologist,3736,4906,8642
4.278299317999966,4.701192739999968,teen,102085,67591,169676
4.776254077999866,5.0427621179998425,teenager,65603,60055,125658
4.070870590000077,5.029297296000031,teetotaler,257,154,411
3.5569692780000395,4.787156062000001,terrorist,295416,128203,423619
4.40722664600009,5.00410120599993,theoretician,771,1015,1786
4.224896274000045,5.039717470000099,theorist,12554,21680,34234
4.679300113999979,4.860537288000145,therapist,22777,12271,35048
4.436983668000003,5.050174177999963,thinker,10763,24490,35253
4.015378842000018,4.371036799999935,thrower,3746,1729,5475
4.080028044000024,4.8845649979999095,tiger,63185,68687,131872
3.37020708,4.4945826460001115,tinker,12559,896,13455
3.9238061140001435,4.32622967599999,tool,328637,374721,703358
3.246033357999984,4.1194099160000235,topper,2650,1031,3681
3.8519634379999843,4.823749778000071,torchbearer,582,392,974
3.593955797999989,4.927299467999944,tourist,69399,74148,143547
4.023465593999909,5.231642295999997,townsman,112,234,346
4.1950679760000185,4.482554585999964,trainer,37221,22594,59815
2.8801393680001013,4.3356244419999825,transfer,291347,51871,343218
3.569361036000096,4.988732165999885,transvestite,1334,528,1862
4.33275930000012,5.003770555999978,traveler,13161,39453,52614
4.555520822000027,5.147619553999924,traveller,8445,18084,26529
4.174561050000108,5.010797068000038,trespasser,779,1158,1937
3.515386606000014,4.797424264000107,trimmer,1631,588,2219
4.41306872199992,5.221092385999874,troublemaker,1592,2295,3887
4.490839516000037,4.833840334000129,trustee,14256,22130,36386
3.7335404000000025,3.527777057999927,turner,65756,643,66399
1.3604204459999707,4.788977661999986,twin,110730,48276,159006
4.611452084000007,5.082418156000102,unbeliever,630,2403,3033
2.963883800000069,4.8194719500000645,unionist,11967,7396,19363
4.536957596000036,4.419181371999997,user,607411,799952,1407363
4.286139544000065,4.894969997999915,vacationer,148,1255,1403
3.6395135120001143,4.705785588000019,vassal,3515,2024,5539
3.8386875760000336,4.595470545999916,veteran,213943,170551,384494
4.084583273999961,4.859168188000034,victim,271100,366143,637243
4.121543569999886,4.895506806000007,victor,66979,3566,70545
4.371354557999993,4.4690325799999115,viewer,44091,140540,184631
4.291394009999976,4.746687968000025,villain,42564,27904,70468
4.051213741999952,4.7949496720000155,visitor,41692,162009,203701
3.832301058000077,5.154117148000083,volunteer,97390,115630,213020
4.636913959999951,5.145236385999958,voyager,16471,1146,17617
3.9465734559999888,4.4025528640000715,walker,133753,9551,143304
4.594149574000191,4.859172670000035,wanderer,2932,9060,11992
4.099896002000008,5.057806785999972,warmonger,1082,1394,2476
4.238436059999991,4.950964623999951,warrior,61742,100220,161962
3.2982723160000376,4.0983159539999505,washer,4666,2466,7132
3.4893088800000456,4.31880964600002,wasp,9809,7184,16993
3.848998182000024,4.484617409999949,watcher,5626,14120,19746
4.267890830000013,4.748356066000028,waterman,1756,370,2126
2.902627530000018,4.812078510000148,waver,2382,854,3236
4.116579341999945,4.6646844979999,westerner,1642,11961,13603
3.9841301639999074,5.027249048000044,whale,50883,37849,88732
4.334347086000015,4.58933491400002,winner,192575,95521,288096
3.329018991999959,4.339492115999903,wiper,2178,1507,3685
3.960988806000067,4.544753676000056,witch,50698,13796,64494
3.7381049440000425,4.72165451399988,witness,166055,123495,289550
4.319302523999923,4.398028647999936,wizard,40268,50075,90343
4.392141371999969,4.8866095699998695,woman,942412,1843952,2786364
4.232418177999968,5.171364800000028,worker,175313,755287,930600
4.3886611619997495,4.864799636000015,workmate,215,672,887
4.389166054000064,5.010623993999928,worshiper,638,3727,4365
4.219122924000018,5.11641107400002,worshipper,1261,7898,9159
4.46480245199988,4.9594610639999885,wrestler,20026,15836,35862
4.611094346000044,4.949956740000083,writer,293224,186923,480147
4.088477457999915,5.07104318199994,wrongdoer,402,1190,1592
4.614328532000002,5.014943426000023,youngster,16268,25665,41933
3.6810547659999955,5.043420077999897,youth,277574,28938,306512
3.9929491680001092,4.971525667999899,zealot,4735,7341,12076
3.3469573480001316,5.107238192000011,zombie,67293,36298,103591
3.8439820100000333,4.7200853960000515,zooid,52,119,171
