s,p,sent,s_freq,p_freq,freq
2.1602946305418413,3.0876122610837626,abductor,998,1004,2002
0.13597739408860576,2.7700816945812647,aborigine,354,2697,3051
1.6536656822659381,3.3279280246305376,abstainer,164,426,590
1.199387315270915,3.050761140394094,accumulator,2194,469,2663
1.5525221403940606,3.437492315270976,achiever,577,1612,2189
1.34637411330052,2.874734943349729,acquaintance,13178,9081,22259
2.461477485221611,3.0883240073891614,actor,199773,143125,342898
2.4227190886699326,2.915982421182253,actress,90150,12160,102310
2.1501231231526567,3.6107364064039693,addict,12455,18953,31408
1.4164198004925623,3.249027093596027,adherent,2216,12743,14959
1.990835068965474,3.018702278325083,administrator,61210,57008,118218
2.3519339581281535,3.2024804999999787,admirer,6444,6882,13326
0.37708783004925195,3.10207183004923,adolescent,26820,18675,45495
0.24396235467983018,3.632444768472876,adult,245407,211316,456723
2.549072871921169,3.1975005788176745,adventurer,6950,8770,15720
2.284594573891688,3.0333427610836985,adversary,14726,15142,29868
1.6399154359605426,3.4208560763546387,advocate,129120,169090,298210
1.9951171995073835,3.1655954162561173,agent,296265,259730,555995
1.1495911748768393,3.5847892955664946,aggregator,5228,2317,7545
0.0789491083743954,3.084791916256144,agonist,4617,3250,7867
-0.3313721995073706,3.378269517241428,albino,4706,945,5651
1.2876608078817569,3.3991957315271293,alien,134423,59864,194287
0.4158220123152532,3.0213535911329714,allocator,2767,684,3451
0.7135768866995065,2.880986711822672,amir,15694,147,15841
1.5219270369458613,2.840926714285729,amputee,2353,1728,4081
1.515395480295588,3.236182677339862,analyst,140326,139030,279356
-0.18492465024632665,3.1683437512315145,anarchist,44060,26033,70093
1.3503712266009131,3.3807685960590987,anatomist,758,396,1154
0.8020259433497117,2.3413216354680166,ancestor,16543,40028,56571
1.7750281280788052,3.542198490147822,angel,71285,52496,123781
1.5878686600985326,3.0012167118226394,animal,376786,323086,699872
1.491809352216798,2.934282450738891,animator,8445,7778,16223
1.0592498571428557,3.0600195295566905,antagonist,12276,6215,18491
-0.11880670197034249,3.230027293103433,antiquarian,1833,197,2030
1.1238313201970627,2.9599875270935385,antiquary,125,240,365
1.5633523522168637,3.399876088669938,ape,11422,13950,25372
1.2646215221675128,4.1162293990148235,apologist,4324,8652,12976
0.16306075369455897,2.9148522881773538,apostate,2730,2622,5352
1.7707717512315746,2.7796963423646375,applicant,21197,49503,70700
2.587800748768437,3.2297228842365087,appointee,7152,11733,18885
0.9040890665024293,2.693465608374364,appointment,84329,30798,115127
2.073327165024594,3.001600672413794,arbiter,7407,2643,10050
2.212401704433489,3.113538376847213,archer,21385,4952,26337
1.532940071428552,2.955096623152663,architect,56275,39639,95914
1.2928390344827747,2.949706197044261,aristocrat,2937,4228,7165
1.4035741748768373,2.821610418719356,artificer,1139,313,1452
1.7911375073891982,2.808297416256167,artist,229336,212484,441820
0.6565452438423733,3.127637066502487,ascetic,3489,753,4242
1.96790134236457,3.3424715591133847,aspirant,1909,1896,3805
1.7219456305418106,2.7921875788177886,assignee,421,164,585
1.6541705714286294,3.314292770935918,assistant,282156,21877,304033
1.3285291231527054,3.161800339901454,associate,161000,55860,216860
1.426810342364515,3.1346713325123403,astronaut,28563,39886,68449
2.392056881773332,3.026836564039378,athlete,58866,116006,174872
1.8021437660098805,2.900928406403864,attraction,52751,22535,75286
2.4904535714286062,3.7566611674876818,author,463215,225163,688378
1.5271511970443434,3.160532172413678,authority,381264,501897,883161
1.7444786551724647,1.684050268472859,automaton,3080,3462,6542
1.2844685221675434,3.332258408867002,baby,297082,89352,386434
0.9599999261083383,2.6590759261083576,balance,328654,26376,355030
1.8568743817733697,3.176987088669886,banker,22058,45232,67290
1.234874384236523,2.830946061576249,barbarian,8538,5867,14405
2.1145649408867087,2.813633899014768,beast,77081,21937,99018
0.646084894088645,3.028755344827573,beater,2111,1081,3192
0.5537787980295548,2.693406133004956,beginner,14917,14870,29787
1.7652789532020172,3.0426148226601093,beholder,1326,155,1481
2.339700736453185,3.0280190812808137,being,5830771,92990,5923761
2.6948543325123744,3.6381613448275267,believer,23513,32466,55979
0.590420339901506,2.9587814014778218,billionaire,71829,22891,94720
2.0070072389162092,3.209876315270911,biologist,26008,18230,44238
1.7083207216748377,3.058827263546892,biter,532,306,838
0.5647315689655876,2.9039357906403502,bleacher,9033,3998,13031
1.5776827068965567,3.0469629975369976,blogger,48537,30692,79229
1.8776420591132634,3.107449142857135,boater,621,2345,2966
1.6539589039409144,2.7085813177339872,boatman,702,526,1228
1.7246020985221655,3.0731363793103412,body,1036949,241587,1278536
0.6328715098521762,3.0982892487684914,bodybuilder,2626,2937,5563
1.1436026428571928,2.658221088669986,bomber,44275,38056,82331
1.6076555172413691,1.891207669950738,bondsman,553,446,999
1.319741541871899,2.693898103448177,bookmaker,1363,2639,4002
0.21936904679799696,3.552866519704427,boomer,6703,15065,21768
0.8015819384236735,3.4803025960591114,booster,26185,10990,37175
1.293216955664949,2.6788882980295483,boss,180377,48969,229346
2.011787298029528,2.8842624852216723,bowman,15464,254,15718
2.2329074802955127,3.522804135467929,boy,344870,247922,592792
1.765467987684687,3.0595301798029517,broadcaster,35350,20661,56011
1.4363637536945824,3.153158891625729,brother,269930,178543,448473
1.6097756502463554,2.34977574876838,brunette,5020,294,5314
-0.24552858374385877,3.280312162561522,buddy,39376,17096,56472
0.6425467315271618,2.8026934999999717,buff,22085,12139,34224
1.5185738743842911,2.8083635123152746,builder,27762,25069,52831
0.6893319334975807,3.0677949458127998,bull,79088,72714,151802
1.614550613300434,2.862497305418742,bullfighter,442,157,599
1.8232509211822716,3.17302999999999,businessperson,803,3522,4325
1.8644221009853297,3.1847240024630494,busker,699,641,1340
0.4275208054187267,2.538414450738877,buster,11618,2333,13951
1.7269937487684395,2.7016850295566144,candidate,506899,347570,854469
0.32323852216752513,3.6893873891625866,capitalist,88834,20133,108967
2.0674850566502876,2.678447519704477,captain,253483,16668,270151
0.5108568472906079,3.3089235197044964,captive,29473,7587,37060
2.214647724137958,3.3011127487684675,captor,1436,5759,7195
1.0177702832512168,3.25237065270937,carrier,98127,59639,157766
2.2863142266008794,2.87818709852219,cashier,7243,2111,9354
0.6024265640394617,3.5692148029556634,castaway,1763,1674,3437
0.7585897315271701,2.96591121428575,category,169959,93878,263837
0.5054455270934888,1.9873157389163438,caveman,2778,1174,3952
2.704847433497431,3.5595335714286165,celebrant,799,1211,2010
1.9842586822660238,3.2280514753694227,challenger,40310,14137,54447
0.6744863866994493,2.906018564039446,champion,203122,176920,380042
1.114199472906332,3.0012111305418507,changer,7475,2584,10059
1.4986944852217583,3.110116655172394,character,690363,486749,1177112
1.6353238940888026,3.1300242463054353,charmer,1023,292,1315
0.547226847290613,3.303210322660089,cheerleader,7129,7446,14575
0.7223659187192304,3.5631173719211198,chicken,149491,26550,176041
0.4061279458128233,2.8516632093596286,chief,930238,83614,1013852
1.9990506280788267,2.75574142364529,chieftain,3107,1644,4751
1.9575470960590984,2.907990778325061,child,741674,1313110,2054784
2.205660125615676,3.2684853423645706,choreographer,2818,642,3460
0.5859465517241915,3.2466446748768263,chum,2631,1083,3714
1.0967014704433247,2.8991434064038977,citizen,148173,424169,572342
2.046042546798006,2.986929758620601,claimant,5792,11538,17330
0.7450072832512653,3.0162945295566566,class,913518,202635,1116153
1.704089716748797,3.156970901477795,classmate,11363,21505,32868
1.6866869852216553,2.6807538004926386,client,217687,162342,380029
1.2756466157635487,3.4705761674876214,climatologist,2607,1710,4317
0.6626752413792332,3.0237741157635014,clone,43670,14859,58529
1.5817304236453111,3.2331349753695093,coder,3689,5606,9295
1.4651618990147774,2.808831256157589,collector,30236,26981,57217
0.29495261576351695,2.5923766034483435,comer,3027,1884,4911
1.8828395344827697,2.8094125172414195,commander,156018,42244,198262
2.025967960591153,3.5711494088670186,commentator,34298,43224,77522
0.9907341945813535,2.8794963694581988,commoner,1658,2323,3981
1.7595993152709681,3.0844666305418613,communicator,3732,1930,5662
0.4063392142857154,3.009489650246298,companion,58412,22314,80726
0.8794261600985038,3.01660953940884,compatriot,3854,5766,9620
1.2646573645320807,2.5127142266009415,competition,333569,30010,363579
1.88537020443351,3.3046920665025077,competitor,38460,70055,108515
1.749703665024665,3.420434677339994,computer,562607,147007,709614
1.6178976330048798,2.7413397955665317,comrade,11084,21797,32881
2.4158625886700733,2.9289919285714134,confessor,1359,345,1704
1.3438591798029442,3.191248517241405,confidant,5843,1721,7564
0.3837839384237327,2.851388556650214,congener,131,343,474
-0.3770330886699469,3.173071280788186,conservative,585591,202174,787765
1.774124790640336,3.2242512881774417,conservator,1620,1052,2672
1.27650155911331,3.030242665024602,consumer,297398,260356,557754
-1.1621726995074262,2.8263990270935864,contemporary,152691,9638,162329
1.5271704137930229,3.162958650246349,contender,41063,30134,71197
2.7363589704433764,3.5438471921182213,contestant,14077,19782,33859
1.7336416453203007,2.8660762216748203,contractor,51364,57007,108371
1.9161730566501944,3.2824300763546788,controller,96056,37150,133206
0.37476316256154263,2.575479652709383,coon,3524,3142,6666
-0.054034009852166776,3.5912395615763657,copycat,5793,1331,7124
0.8470587068964832,3.2001169113301273,cosmonaut,3588,2930,6518
1.735068007389188,3.571571470443395,cottager,50,492,542
0.8110087610837731,3.1411935369458313,counter,183062,23621,206683
1.2064030024631158,3.1094208719211984,cousin,49538,40521,90059
0.648299014778356,3.358113830049252,crab,18863,8318,27181
1.3869570566502851,2.5946233152709546,craftsman,4117,4467,8584
1.391474837438487,3.4891352561577023,crawler,4268,2353,6621
1.7693523349753058,3.3294163522167395,creator,102790,75996,178786
3.0494346453202397,3.0446444679802553,creature,108032,110048,218080
2.327600995073901,3.021286940886725,creditor,5230,21247,26477
1.264634172413782,2.925533546798004,cripple,10583,1534,12117
0.460834401477797,3.4332771724137174,crony,8187,6419,14606
0.4442394236453353,2.6540038004926316,crossbreed,466,137,603
0.48436825369466163,2.669370088669943,crusader,12713,10185,22898
1.0790683201970097,2.730646825123184,cultist,1507,2684,4191
2.810919778325122,3.513909965517289,dancer,15972,17784,33756
2.8142669482758613,3.3427015246305736,debater,1370,1468,2838
2.4251378325122737,3.218576610837438,defender,117539,86322,203861
-0.3291945837439698,3.0638456699506946,deist,675,476,1151
1.2053351896551376,3.12563006403942,demigod,1481,711,2192
1.459358103448217,3.184175650246292,demon,40968,30127,71095
0.7392604581280402,4.046092379310323,denier,4148,7311,11459
1.9961274827586273,3.4592990344826973,denizen,1204,6409,7613
1.1961917364531907,2.9328975049260926,descendant,10774,30422,41196
1.0988456305418666,3.0409845270935776,descendent,2026,2185,4211
0.5868500443350584,2.734435293103445,deserter,1184,1974,3158
1.5943449236453198,3.0322013891625375,designer,117125,79755,196880
1.600399549261173,2.8405896724138167,developer,220575,332059,552634
2.8012341330048507,3.513378497536916,devotee,3495,8903,12398
2.0935980566502437,2.8274919729064436,dictator,31781,10532,42313
-0.4433860049262677,3.187271721674854,diploid,1343,49,1392
2.264508768472883,3.113418916256162,director,1075374,90402,1165776
2.5071888866995096,3.1096758940886637,disciple,8693,15346,24039
1.4288893103448217,3.0547846502463543,discoverer,2175,959,3134
1.9179522955664936,3.7378695689656176,dissenter,1161,5676,6837
1.3931792758620531,3.0740492266010264,distributor,18499,19609,38108
1.3422398916256917,2.381824246305378,diver,9079,15982,25061
1.2141543078817953,3.222465061576411,divider,2823,1424,4247
1.9261139458127623,3.30240307389165,doer,1249,966,2215
1.8407801600984683,3.601515174876866,doubter,421,5095,5516
2.1398022463054254,3.0957056822660682,dreamer,4988,8658,13646
1.1196391748768413,2.6056747192117733,dresser,3907,673,4580
1.9257899630541466,3.2646494581279484,dribbler,548,180,728
1.8656534827586384,2.929770955665088,driver,331017,250280,581297
0.08859416502463802,2.934830884236419,dropout,7558,3230,10788
0.048372150246279944,3.0580668694581767,dupe,3183,1850,5033
1.2392076502462785,3.3068251798029706,dwarf,36582,8124,44706
2.319945108374334,2.903007179802959,dweller,2203,8112,10315
0.615888637931107,2.772584512315241,dynast,162,168,330
0.8304899014778933,3.3268406551723615,elder,73271,24336,97607
2.3987895689654763,3.5510508743842806,emcee,2590,827,3417
1.8892027660098805,2.8955631379310063,emir,6569,602,7171
1.8943375123152677,2.8992052906403565,employee,200643,435134,635777
1.3995333472905536,2.9679247142857683,employer,69758,113415,183173
0.8823987586207096,3.310633258620591,endorser,887,910,1797
1.404716448275888,2.848093748768431,enemy,258760,159377,418137
1.565688263546818,3.521361379310374,engine,306340,90589,396929
2.0401227118225727,3.0018851133005455,engineer,122504,134789,257293
1.7022305911330022,2.675323440886686,enrollee,1408,6384,7792
1.8388669187191837,2.831161283251255,entertainer,6554,5577,12131
-1.2857942019704929,2.354948950738901,equal,301687,32146,333833
1.2458118940886713,2.944705187192149,estimator,1851,812,2663
0.19504839408863717,2.967497652709433,eukaryote,343,1452,1795
1.2039698078817764,2.5088906009851755,exchanger,1553,879,2432
1.8385335935960896,2.913853655172442,executioner,4454,1712,6166
1.8213269211823118,3.1206827512315662,executor,3148,1341,4489
2.139161556650304,2.305853332512285,experimenter,4456,3031,7487
0.7378712931034812,3.397779603448317,expert,230712,352516,583228
1.522019583743802,3.024037903940915,explorer,45025,14386,59411
1.251287256157621,2.86946447044339,exterminator,867,416,1283
0.27081816256163194,3.044734911330078,extremist,63574,44445,108019
1.1543800147782974,3.2956285246305406,face,1141842,268846,1410688
0.054864610837437766,2.9924343916256007,failure,319477,64079,383556
0.6037365738916449,3.0390200665024167,family,1698371,468573,2166944
1.4742937709359722,3.4642074310344952,fan,390877,819281,1210158
2.350131433497495,3.0701751083743964,farmer,55493,170886,226379
1.0473775197044617,3.1819386280788464,fastener,1008,1482,2490
1.7471559630542366,3.031758285714158,father,560727,57378,618105
-0.4297644999998944,3.1170827684728337,favorite,566791,39200,605991
0.5684302660099085,3.0827138817733655,federalist,10773,1911,12684
2.225174662561596,3.415797325123126,fella,3341,2032,5373
2.1597197955664775,2.434095647783252,fellow,403431,11927,415358
0.5159295788176799,3.371310059113231,female,530753,68014,598767
2.8517510369458634,3.3851167118226115,fencer,2674,1738,4412
-0.17395694827591512,2.6014658842364327,feudatory,49,48,97
1.9770648448275914,3.3926357586207097,fighter,161699,199203,360902
1.9165223029556522,3.299731805418709,figure,760376,348399,1108775
1.9793503891625228,3.1692502463055057,financier,7841,7358,15199
1.009347268472851,2.2604548546798,finder,9627,1779,11406
0.15971773645329534,2.6514801133004475,finisher,7080,4879,11959
1.6848046059112676,3.5413086674876197,flatmate,794,544,1338
2.0948540418718906,3.2087818374384227,flier,6759,9655,16414
1.750443583743806,3.134508433497519,flyer,16207,40549,56756
2.7926136354679727,3.0047028472906803,foe,16945,21576,38521
1.4263780123152543,3.1333834039408544,follower,14780,106645,121425
1.9414988103447541,3.0885918472906795,fool,42080,15039,57119
1.6565817610837037,2.9680719753694653,foreigner,10236,48499,58735
0.3679351477832711,2.7499956403940615,forerunner,6863,2052,8915
1.6806716945813065,3.351783083743875,freelancer,5327,6525,11852
1.6570503866994812,3.084101194581276,friend,541766,796235,1338001
1.3278430073891592,2.0526405418719307,frogman,280,300,580
2.372968613300518,3.0253470615763725,fucker,1628,1415,3043
2.4527128201969894,2.9616382167487707,gambler,3822,5009,8831
1.5622222339901732,3.460748564039413,gatekeeper,4921,5440,10361
-1.035939985221713,3.551871881773316,gay,422991,33016,456007
1.858961655172493,3.481909825123175,genealogist,458,369,827
-0.2837308349754224,3.4138525566502516,gentile,5383,3576,8959
1.5884962068964725,3.245017386699452,geographer,2438,1059,3497
1.7519462216749062,3.454257603448248,geologist,7670,6851,14521
-0.04288674384240565,3.1183264778324826,giant,323138,137928,461066
2.351006325123187,3.1573851970443414,girl,421549,356727,778276
1.848142859605911,3.2152154876847767,girlfriend,73703,8158,81861
2.2075673522167634,3.355938460591098,giver,3634,1963,5597
1.09302605665032,3.36705032266007,goat,28023,15779,43802
0.9171236625615613,2.9386570000000063,goon,3769,5611,9380
0.13874132758616398,3.9453071083743723,grownup,1128,1312,2440
1.3597400615763426,3.056607945812786,guardian,142509,35886,178395
0.2275170935960631,2.923500980295536,guerilla,6257,1046,7303
1.8442700714285714,2.9618249261083953,guide,288542,46739,335281
0.289459290640405,3.308104655172375,gutter,5070,1861,6931
0.974293652709342,2.7263595566502055,hacker,53067,77753,130820
0.9610603571428165,2.7652819778325153,hanger,4473,2044,6517
1.1557929310344548,3.613678965517259,hater,2711,9670,12381
0.6956101527093992,3.1944594630541943,head,1389552,220981,1610533
1.784155266009833,2.673488625615775,headman,489,158,647
2.7181981748768322,3.7906717832511276,hearer,582,674,1256
-0.2405099605911616,2.8042086748768718,heathen,3771,1468,5239
0.4461813078817798,3.572029352216667,hedonist,452,258,710
0.8336665221675474,3.0055324926109073,helper,18222,8071,26293
1.7188468300493298,3.469875995073849,hero,190739,136373,327112
0.18604300246308725,2.7427953620690104,hobbyist,3975,4615,8590
2.2743017660098204,2.6076545640394855,holder,71229,57763,128992
1.7264496798029612,2.822524775862007,holidaymaker,299,2009,2308
1.723048490147761,2.874811502463036,homeowner,15601,37775,53376
-0.6298259975369831,3.433700426108352,homosexual,44888,16051,60939
1.5608015295566275,3.383449081280837,horticulturist,359,181,540
1.3634671995073369,3.102239857142873,host,454280,106233,560513
1.7966338891625568,2.2790790270936796,householder,2735,1649,4384
1.3799425985221596,3.330214145320152,hugger,466,363,829
-0.13730266502462385,3.3300086231527004,humanist,14279,3985,18264
1.4352867536946476,3.291842485221686,humorist,1233,277,1510
0.5216183399014653,3.593417630541886,humpback,5221,1022,6243
1.8692314137931056,3.2189105738916908,hunter,101381,42584,143965
1.9104055615762547,2.745512761083809,husbandman,79,83,162
-0.353653527093563,3.195119849753702,hybrid,94391,11371,105762
0.5139266108374407,3.5620358522167095,idealist,3203,2080,5283
1.0224840369457588,3.1880353965517543,idiot,21041,13299,34340
0.4558690714285625,3.2433763571428607,idler,712,308,1020
1.5578947438422794,2.9009427192118338,illusionist,982,282,1264
1.698898413793163,3.493492679802962,imam,26463,6346,32809
1.9305465886700048,3.940145376847287,imitator,409,1880,2289
-0.12584030541869495,3.485574086206924,independent,576562,27512,604074
1.6180903793103774,2.2524302512314556,individual,735597,492543,1228140
0.5542320763546584,3.201933027093652,individualist,4331,1058,5389
1.4916552413794193,2.8478177389162234,informant,16362,9681,26043
2.379695724137928,3.25003951970438,initiator,2547,1247,3794
1.4796611502463186,3.0120080123152135,instigator,2678,1448,4126
0.46854305172412225,2.8382480541872326,insurgent,19540,26709,46249
-0.2893561182265145,3.6275428374384866,intellectual,168356,22698,191054
1.526799559113286,3.3167441871921284,interloper,1159,1148,2307
-0.44445057635474683,3.4861938620689585,internationalist,4415,900,5315
2.4343335591133624,2.9686121822659537,investigator,48561,196321,244882
1.6587696354679942,3.0650489482759014,investor,74569,234503,309072
1.3736243399015642,3.2249053103448126,islander,5961,28312,34273
-0.28573964532020213,3.364793682265862,isolationist,3955,596,4551
0.15010608374382173,3.94351497783256,jock,6240,1913,8153
2.061012891625559,2.77851671674874,judge,592105,144717,736822
2.004189162561566,3.464361766009816,jurist,3458,3323,6781
0.11482616256165556,2.9538853694581704,juvenile,47332,10197,57529
1.1589676600985896,2.6482293374383588,khan,90579,3075,93654
2.3962628842364637,3.390867519704514,kid,188924,557940,746864
1.6843169532019928,2.856414108374377,kidnapper,1640,4212,5852
0.9885494778324926,3.0271669458127732,killer,112088,27958,140046
1.5756774334974466,2.2062174458129107,kinsman,1206,773,1979
0.89432975615766,2.8450773817735033,knocker,371,288,659
1.9657946453202086,2.794250059113324,lawgiver,440,118,558
1.7130755862068874,3.0966217610837212,lawmaker,33866,211575,245441
1.1629499162560997,2.115821667487623,layman,3379,1492,4871
1.2669798275862156,3.2578924482757614,layperson,1085,1586,2671
1.4387361674876082,3.181346039408794,leader,762448,678185,1440633
0.5498183940887138,3.297999798029551,leech,6040,2231,8271
0.5497157881774122,3.570199945812874,lefty,14605,6811,21416
-0.6205759655172223,3.443438401477785,lesbian,58344,18989,77333
-0.28498734482759147,3.4551673054187404,liberal,401555,136494,538049
-0.16583129310345512,3.567742586206844,libertarian,87027,28531,115558
0.26330034482763764,3.102606790640351,libertine,1260,569,1829
1.5243862364531537,3.6398030714286627,linguist,5220,5323,10543
0.8203908226600447,3.18203150738913,lion,52581,97033,149614
1.7799996330049694,2.718137995073853,liquidator,704,1129,1833
2.207260226600969,3.2164947586206445,listener,21817,35683,57500
2.0633964014777533,2.935148482758713,litigant,1055,2550,3605
1.0379384088670633,3.825772857142809,logician,624,692,1316
1.9140553596059675,3.1728607955666206,logistician,120,174,294
1.4863103374383329,2.669820736453225,looker,596,118,714
1.1153178768472607,2.5168320591133195,lord,237751,34623,272374
2.77105962068962,4.127308679802926,loser,19871,24029,43900
0.804937298029504,3.1853969729064353,lot,2775567,360227,3135794
1.2940002413793152,3.0603598152709424,lout,400,349,749
2.0826177093595746,3.256111507389182,lover,30166,36505,66671
0.3433822881773416,4.168296413793097,lunatic,8770,2652,11422
2.3819820098522193,3.8231254926108598,machine,382474,163748,546222
1.5597401453200739,3.3787749261083277,mailer,4892,2509,7401
0.8743188448276129,3.3039389729064332,maker,79167,84270,163437
0.6939540935960835,3.7311127339901518,male,443669,90666,534335
2.4584222413793633,2.7444950344827035,man,2058373,1477560,3535933
2.3693590320197586,3.5310673940886694,manipulator,3795,1858,5653
2.091426352216711,3.344160780788208,marcher,864,9530,10394
0.32670615024630223,2.6629409408866884,master,263405,79403,342808
1.2218230615763233,2.7377880591132673,mate,60970,20464,81434
0.4076180467979711,4.093371386699474,materialist,4999,806,5805
1.5722595246305318,3.284647586206905,mentor,36788,11416,48204
0.6895905911330367,2.7850724556650555,mercenary,14516,12564,27080
1.5390290862069094,3.222604738916246,metallurgist,274,203,477
0.4410433842363872,3.0301484753694368,midget,4102,721,4823
0.3861650246305359,3.0441848866995365,migrant,56757,118605,175362
-0.07854519950732453,3.572844805418704,militarist,1473,638,2111
-0.235820224137953,3.332560366995061,millenarian,684,56,740
0.589698768472875,2.99156084482755,millionaire,14951,12219,27170
1.0107438916255873,3.278069197044246,mineralogist,205,50,255
0.6803072931034535,3.0232482339900777,minor,273713,30644,304357
0.5911513522168015,3.4204947142857556,misfit,3680,6568,10248
0.4665294334974952,3.156806440886701,missionary,21192,16467,37659
1.4263941871921055,2.7814078300491687,model,800618,319129,1119747
1.792900977832577,3.1382249088670733,modeler,1193,1821,3014
0.2805731453202185,3.7173044482759607,moderationist,6,9,15
0.96205838916255,3.0546276527093923,modifier,14462,6303,20765
1.1320458891625407,3.133310110837506,moneymaker,955,281,1236
1.8304928866994992,3.093023652709391,monster,139425,74076,213501
1.4902661502463168,3.038820778325139,moron,3656,3454,7110
0.201257815270953,3.3328203645319583,mortal,34611,5028,39639
2.3585727660097717,2.9879662364532216,motorcyclist,3729,3308,7037
1.5060211921181619,3.2252581871920682,mountaineer,2238,3974,6212
1.296377364532038,2.088026206896572,mouse,106737,105286,212023
1.758462756157563,3.3292773472906454,mover,5738,6198,11936
1.9423492192118843,2.891070266009809,murderer,18445,12226,30671
2.2399165788178266,3.977409714285713,musher,346,429,775
0.29370301724133085,3.1813447142857143,mutant,28804,11040,39844
-1.1232898226600554,2.5614500394088715,national,2686417,66786,2753203
-0.08885490640396654,3.2787828399014742,nationalist,71245,25989,97234
0.09560492364533602,3.2533255221674473,native,367344,19769,387113
0.1652929655171782,3.067142793103571,naturist,2096,789,2885
1.702776682265963,2.9196130566502703,navigator,8245,2491,10736
2.157032302955759,3.24130295566507,negotiator,11606,18663,30269
1.4205100221675586,3.1452465443349134,neighbor,58872,97443,156315
1.432765647783178,3.1465085763546696,neighbour,19344,34003,53347
0.39942819704434385,3.861260992610802,nerd,18717,12080,30797
0.9083654679803459,3.7428806896551734,nestling,1074,595,1669
2.280366004926023,2.673869162561587,newsman,1226,526,1752
0.7406955788177569,3.735578935960554,nihilist,1490,751,2241
-0.23124004433497447,3.9408211280788024,nonconformist,751,255,1006
-0.10539410098528634,3.401888332512339,nudist,3149,1128,4277
0.8526560270936514,3.293891500000086,numismatist,257,248,505
1.3730048842364688,3.37742509852211,objector,1500,2098,3598
1.8317380073891698,3.181311194581255,observer,54918,73140,128058
1.072519935960667,3.0157246699507745,occultist,1324,875,2199
1.8275237044335277,3.2075204655172413,occupant,6825,15213,22038
2.1526092955664353,3.081992716748694,occupier,2003,8418,10421
1.275233448275948,2.9464650270935877,oceanographer,1999,690,2689
-0.570471275862058,2.800718613300475,oddball,5621,672,6293
2.552643798029642,2.6170987906403873,offender,28947,47808,76755
-0.04797846551732121,2.9115054359605708,official,1022849,1170063,2192912
1.7256336699508168,3.36194199014777,oiler,1102,23280,24382
1.8269406699507478,3.268898120689663,operator,91301,91222,182523
2.5025663054186786,3.0088133546797984,opponent,176745,207959,384704
2.493974273398983,2.6469151157635906,organism,18722,38223,56945
1.5054266403940844,2.561948347290695,originator,3938,1812,5750
0.07338444827581014,3.0870503793103445,orphan,12912,7628,20540
0.8717077413793248,3.6223602266009785,outcast,5159,2635,7794
0.7485412610836164,2.477167761083706,outdoorsman,743,292,1035
0.8668698325123394,3.318419256157604,outsider,21009,24531,45540
1.618074524630643,3.2889199285713673,overlord,7333,4437,11770
2.3100582167487644,3.1129212339901606,owner,329155,309636,638791
-0.3284066995074326,3.4145258940886976,pacifist,6077,1463,7540
0.38648976600989826,2.107119918719217,pal,19389,10973,30362
1.4925768916255606,3.0807197019703594,palaeontologist,1164,980,2144
1.553595753694566,3.0305627512315425,paleontologist,4025,4084,8109
-0.161463785714286,3.3084291428571255,pansy,988,299,1287
1.2377677660098598,3.0690113103448695,parachutist,464,296,760
0.25509720935964,3.263427032019706,paraplegic,1175,328,1503
1.5427974310344865,3.144085007389151,parasite,14368,13015,27383
0.8953541477832765,3.459363795566535,parent,167159,605176,772335
1.7004719999999622,2.76725214778331,parliamentarian,5506,8360,13866
1.4804807832511742,3.3793959113300964,parrot,11545,4788,16333
1.9823564064039516,2.883608032019758,participant,43546,255180,298726
-0.7727277536945749,3.357283305418818,partisan,74546,9746,84292
1.552623231527079,3.2730552561575585,partner,294528,213400,507928
1.6218086945813255,3.308634721674867,party,1679913,387168,2067081
0.754153300492586,3.076243640394079,passenger,117560,144367,261927
1.05921203448273,1.6107438251231656,passer,22013,3532,25545
2.305841559113272,2.7776637660097876,patient,214098,448648,662746
-0.1978636453201439,2.9326029802955773,patrician,1992,524,2516
1.665899130541952,2.9513513571428405,payer,8917,4738,13655
0.75462316502459,3.1944454556650044,pedestrian,44929,30149,75078
0.5033713448276345,3.0294708128079115,peer,64685,59742,124427
0.21952034482758265,3.513890366995085,perfectionist,2644,654,3298
2.564803108374406,3.1705053029556716,performer,26881,36524,63405
2.720507807881816,2.6675962758620493,person,1285464,9341934,10627398
1.5705818078817586,2.2819844802956055,personage,1032,892,1924
0.5611706403941383,2.5621934261084647,personification,4186,471,4657
0.20924783743842568,2.8833337832512598,pet,107029,37318,144347
1.8430278128078754,3.5092638004925902,philosopher,36863,29693,66556
1.6494878177340055,3.4215294211822354,physicist,27884,23343,51227
1.1782205862068373,3.235849842364644,picker,4337,2498,6835
2.304319098522196,3.378045943349779,pitcher,63997,41173,105170
1.6016876009852012,2.9199554753693846,planet,242895,69186,312081
2.0750386083743138,3.4679676133004236,planner,15635,26112,41747
1.686949103448299,3.4437728275862085,plant,341368,238723,580091
1.1987225270936506,2.6424871182266294,planter,3121,3766,6887
1.6459046231527523,2.398679455664954,plantsman,13,1,14
2.483134229064021,3.259881662561561,player,1194193,1628482,2822675
1.2819101847290781,3.761616051724168,pleaser,548,183,731
-0.36998209852214003,3.4847883596059646,plebeian,978,444,1422
1.7536235517241678,2.8976742783251233,plotter,1030,3492,4522
1.6021642635468183,2.6020676847291355,poisoner,330,218,548
2.1464872463053943,3.463419655172384,politician,85261,277559,362820
-0.17607980049260874,2.5838105788177828,polyploid,207,78,285
2.5512358275862077,2.999531197044327,possessor,1679,826,2505
1.331132283251197,3.189310551724141,poster,78313,50297,128610
1.5824574039408787,2.705944701970438,potentate,345,461,806
1.2514234753694709,4.120446051724073,pragmatist,2078,1175,3253
0.7640091403940659,2.799343113300477,prayer,91560,52708,144268
0.1572170886699631,2.5316283497537526,predecessor,32632,17158,49790
2.0742365147783204,3.1504412044334877,prisoner,54598,123489,178087
1.849373283251257,3.0430330270935606,processor,69608,34350,103958
1.9877234975369582,3.290937431034507,producer,174531,129671,304202
0.0058555320196624905,3.432396881773375,professional,473027,99041,572068
2.0881758349752886,3.7041044334975552,profiteer,651,1852,2503
2.3794708669950957,3.158184940886674,programmer,33606,38023,71629
-0.7217630837438378,3.0723713078817667,progressive,225347,36828,262175
0.2914316330049189,2.928704711822796,prokaryote,139,639,778
0.6189382980295335,3.5658383374383718,propagandist,3413,4275,7688
1.621183766009807,3.357820623152705,propagator,445,362,807
1.5166921896551564,3.0730032832511966,prophet,63528,13896,77424
2.4440749064039657,3.4692740615763995,proponent,18988,48141,67129
1.0557425197044097,3.4957604384236163,prospect,172517,108779,281296
2.517225950738883,3.007407123152664,protagonist,34384,12718,47102
-0.2708503374384925,3.5732288990147723,protectionist,8002,387,8389
1.6368578694581437,3.119224559113345,protester,24545,230790,255335
2.0462160985221196,3.1680988842364357,publicist,7827,1620,9447
1.3895613596059349,3.238438896551788,pugilist,604,199,803
1.0812545665024835,2.579659302955598,puller,1055,424,1479
1.4270337019704478,2.9743356453202168,punter,7839,4391,12230
2.3375234950739134,3.648079243842325,pupil,14328,30410,44738
2.2213166206896275,2.964486248768484,pursuer,774,1324,2098
0.6691698719211665,2.938895362068962,pussycat,921,366,1287
-0.9104416453202013,3.641858017241347,pygmy,3611,1081,4692
0.6700332512315406,2.910007721674827,qualifier,22921,16741,39662
1.7306996576354763,2.48540128078821,quarryman,47,194,241
2.0149441231527376,2.9430207216748734,queen,166245,44241,210486
-0.7565289827586064,3.255787657635551,radical,223315,20367,243682
0.6257618866995323,3.657853197044304,rafter,766,3559,4325
0.9352522290640586,2.7612460320197165,rat,46030,57252,103282
0.7176463522167609,3.382014963054118,rationalist,3321,1348,4669
0.9200809211822936,3.342512901477839,raver,552,763,1315
2.3803075123152766,2.675256179802993,reader,147724,242637,390361
0.9432146280788807,3.8716576256157182,realist,6623,2829,9452
1.7627008965516957,3.1171599039408804,receiver,134662,52650,187312
1.9490715172414212,2.934760798029668,recipient,42592,44845,87437
1.3698265123154059,3.263647349753647,rectifier,838,211,1049
1.10492143349758,3.25375381034479,recusant,74,45,119
0.13515773152702337,3.225963790640357,referral,17288,8921,26209
1.6891039950738822,3.0285312364532615,reformer,4929,12259,17188
-0.21923237684728747,3.1511010147782343,reformist,9514,2543,12057
1.599869268472876,3.0516614384236895,regent,9097,9268,18365
1.8784653349753384,2.7354121453202183,registrant,2429,2355,4784
-0.9857014630541912,3.347974194581262,regular,549196,11849,561045
-0.6021987635468626,3.133413549261224,relative,254163,84651,338814
0.035941743842428764,1.6913437389162596,relict,508,111,619
0.2115153349753669,3.0201321182266234,renegade,10140,4109,14249
1.2197968965517418,3.1805295344827798,repeater,2657,1060,3717
0.029411665024618117,3.2559828891625244,replacement,143318,15227,158545
2.352301512315357,2.886982194581254,reporter,211728,263164,474892
1.1446989778325438,3.0605313349753587,representative,228263,198721,426984
2.022419278325188,2.7000729310345513,rescuer,1864,12757,14621
2.0985724605910896,2.985420948275781,researcher,112724,586536,699260
1.0297960566502269,3.285492684729043,resident,168263,452813,621076
1.9870474975369952,3.524495379310398,resister,418,1559,1977
1.818241083743839,2.830632721674874,respondent,10520,91738,102258
0.5345188325123544,2.85171997783252,retainer,2601,1285,3886
1.2137434729063337,3.104786581280809,revenant,3238,576,3814
-0.8496436798030054,2.763394347290543,revolutionary,152328,14010,166338
0.07941242364529444,2.7122826551724373,revolutionist,354,428,782
2.5098994679802793,3.4285519852216524,rider,59330,89015,148345
0.7973569901476942,2.334634371921176,ringer,3878,796,4674
1.2485441330048523,3.4291400049260616,riser,2631,1671,4302
0.9416373965516982,2.9965858004925927,rival,145754,80130,225884
0.8040322881773427,3.1640703694581376,rock,405818,77990,483808
-0.12882616995067053,3.1469941576354046,romanticist,156,55,211
-0.12801457635466562,2.853574229064016,rounder,4276,1024,5300
2.2320770591133154,2.9778456674876352,ruler,29619,28332,57951
2.2179510665024083,3.168368312807832,runner,56065,44130,100195
0.6292615985221488,3.0745311551724193,runt,1168,220,1388
2.0698165788176297,2.8535104729064074,sacrificer,48,23,71
1.865103613300473,2.7752587857142217,saint,91005,82850,173855
1.2476351453201815,3.3081845714284768,salvager,183,249,432
1.6854454926108033,3.0203043472906046,salvor,110,90,200
0.8808249433498254,3.509151573891547,satellite,155698,48295,203993
0.8059677660098501,3.1430623546797776,saver,5048,6053,11101
1.6811115295566132,3.77329424876838,scab,1708,1427,3135
0.7107324778324866,3.4378842068965625,scalawag,102,157,259
2.5067438374384743,3.499094027093662,schemer,957,592,1549
1.6894055665024936,3.1596950492610816,scholar,98726,92386,191112
1.210833199507384,2.803384266009772,schoolfriend,141,109,250
1.3963369359606261,2.8822711674877155,schoolmate,794,1297,2091
2.3339975985221812,3.020582948275937,scientist,137342,480352,617694
1.549126352216767,2.9126988325121808,scorpion,9151,4417,13568
1.3219378645320496,3.2326437536945924,scout,58697,49365,108062
1.2892088719212147,2.633868477832511,screamer,1129,447,1576
1.3098406256156885,3.662675884236478,scrubber,735,659,1394
2.056950778325117,3.2892344753694154,searcher,1362,4092,5454
-0.10465646551718777,2.964172403940964,secessionist,3825,1180,5005
0.27534557635462775,3.7475582438424446,secularist,2688,3366,6054
2.2738900221675244,3.1378107561576343,seeker,14349,43675,58024
1.4307500689655974,2.474963746305498,seer,5043,1303,6346
0.7243588004925954,2.568091738916266,self,194672,7631,202303
0.42193319458128187,2.8273070073891517,senior,697277,38826,736103
0.1807455862068359,2.7629480098521455,separatist,23189,19388,42577
1.60654626108375,3.0030535172414154,servant,28622,36695,65317
1.2685954014778567,2.997110268472884,shaker,6143,2982,9125
1.2538317610838128,3.133635381773445,shark,59423,53805,113228
1.7804462955664704,2.7677925492611024,shipowner,154,324,478
1.692570982758621,2.5785161280787463,shooter,74637,28729,103366
1.1227194137931527,1.3731781600985258,showman,2326,253,2579
0.7163627635468437,3.260500293103462,sibling,15055,32713,47768
1.8066766699507326,2.8297805369458047,signaller,198,145,343
1.1654928201970485,3.704047647783238,signatory,6274,11312,17586
1.90716827093593,3.208723204433511,signer,2372,3843,6215
2.2452174187192178,2.998570770935938,sitter,2794,1094,3888
1.1102914433497482,2.9002267389162277,slave,77530,57420,134950
1.1180301699507176,3.3766439704432862,slinger,671,410,1081
1.306999118226667,2.8387331798030004,smith,384577,4840,389417
1.8053577955664366,2.7795045788176758,snake,53335,22641,75976
1.7248668004926166,3.2523959827586637,snowboarder,1465,1328,2793
0.9820691699508259,3.037236583743816,source,890627,469592,1360219
0.7257129236453608,3.4795837561575595,southpaw,3860,562,4422
1.3768504532019854,2.6487133743842435,spaceman,880,507,1387
1.1148340172413604,2.689718662561642,spade,5482,3970,9452
0.8460749556650065,2.9435554039409553,spearhead,6754,1048,7802
0.8891218103448111,3.1780154211822733,specialist,80426,36213,116639
0.2462994433497414,3.0638215492610215,specifier,832,467,1299
1.570152438423662,3.1742014433497623,spectator,16339,21772,38111
1.282327766009832,3.205720221674934,speculator,1487,9186,10673
1.7687303916256738,3.275582330049307,sphinx,5208,516,5724
1.1513043694580922,2.9750289729064114,splitter,4739,775,5514
0.3838375788177366,3.544205216748754,spoiler,30630,20296,50926
1.4547189088669832,3.149508758620634,sponsor,65597,48205,113802
0.916328655172368,1.5017902142857267,sport,216777,541162,757939
0.920281007389125,2.7292766674876674,spotter,2500,1804,4304
1.9811380492610269,3.102749071428523,spouse,28673,17571,46244
1.0591191354680198,3.807423684729031,star,832762,308789,1141551
0.561586576354717,3.510348152709355,starter,85343,36256,121599
0.8080994285714311,3.1597613251230996,stooge,1785,3452,5237
2.1864486206896068,2.9337599852216982,stranger,68755,41913,110668
0.6039557438423344,2.5113192315270467,strikebreaker,49,459,508
1.6639966847290069,3.232052913793133,striker,69432,18984,88416
1.1850387241379465,3.029078697044305,stringer,5289,610,5899
0.8437963940887272,3.299655733990207,stripper,4903,3000,7903
1.4753070270935602,3.2207908793103357,student,633815,1072692,1706507
1.6975573596059412,2.343084955665045,subject,536422,145054,681476
0.18132533004932938,3.1489471625616403,substitute,66352,11268,77620
0.3473432807881771,2.77608763546797,successor,51431,9675,61106
3.027211487684724,2.768022482758578,sufferer,2950,9269,12219
-0.5078937586206393,2.4012662487684935,suffragist,554,679,1233
-0.19810561576355568,2.938027155172332,superior,142577,11679,154256
0.09806366256153964,2.874564605911349,superman,53936,631,54567
-0.5764134211822984,2.6381111379309985,supernumerary,526,36,562
2.4297901354680107,3.4568226921182514,supplicant,541,424,965
1.115169096059116,2.8160435837438627,supporter,87759,395558,483317
1.5855604137931714,3.442799970443275,suppressor,3720,1854,5574
0.06814675615765964,2.992112034482677,supremacist,28433,16498,44931
1.4048386748768422,2.8364293448276072,surveyor,4009,2572,6581
-0.3863683103448068,2.5890416108373415,survivalist,2191,786,2977
1.8958472758620175,3.48816442118229,survivor,47669,77634,125303
1.3784953275862613,2.46640094334974,suspect,265635,114292,379927
1.5884601798029045,3.046184758620651,swimmer,8628,9263,17891
2.2063723768472734,2.402788665024584,swordsman,2783,782,3565
1.7409296133005192,3.2717760541871357,sympathizer,2118,6120,8238
-0.2931260689655346,2.7993831280788513,syndicalist,1840,683,2523
1.8918679310344544,3.278773288177348,tactician,2485,597,3082
1.2365044679802821,2.970938354679781,tapper,10213,288,10501
2.507396426108407,3.243199928571425,technician,18692,18233,36925
0.9708216724137522,3.6889735812807523,technocrat,1427,2899,4326
1.717013332512355,3.586422049261067,technologist,3736,4906,8642
0.9837433743841935,2.9922282832512117,teen,102085,67591,169676
2.2270868546798006,3.207619406403939,teenager,65603,60055,125658
1.0295881921182684,3.7740277290640023,teetotaler,257,154,411
0.42188358866994236,2.7270844334975344,terrorist,295416,128203,423619
2.001537657635481,3.5771201921182296,theoretician,771,1015,1786
1.946434847290579,3.4909120985221698,theorist,12554,21680,34234
2.72336514532018,3.364649881773431,therapist,22777,12271,35048
2.0897087832512433,2.9619803103448596,thinker,10763,24490,35253
2.1585034507388876,2.5018396133005325,thrower,3746,1729,5475
1.195531113300472,3.1977645615763564,tiger,63185,68687,131872
0.2901694556650938,2.8188454556650555,tinker,12559,896,13455
1.118345229064019,3.179080864532036,tool,328637,374721,703358
0.6028099162561631,2.9691106034482644,topper,2650,1031,3681
1.5194356699507452,3.129759647783345,torchbearer,582,392,974
0.36917204187193775,3.1507856748768717,tourist,69399,74148,143547
1.6553334704433738,2.6438083275861928,townsman,112,234,346
2.1694202019704996,3.499251987684815,trainer,37221,22594,59815
0.2694601699508219,2.9150530517241577,transfer,291347,51871,343218
-0.3235891551725132,2.862835179803021,transvestite,1334,528,1862
2.421138113300511,2.8207871256157127,traveler,13161,39453,52614
2.3663311059113177,2.9375579014778594,traveller,8445,18084,26529
1.5218457807881514,2.906678674876872,trespasser,779,1158,1937
0.63426607635461,3.137069726600945,trimmer,1631,588,2219
1.0917332512313678,3.0897644827585964,troublemaker,1592,2295,3887
1.88352763546796,3.0754681231527137,trustee,14256,22130,36386
0.17951433743845513,1.8221110443349886,turner,65756,643,66399
1.4032599963054118,2.4360652339901776,twin,110730,48276,159006
2.7343368965516923,3.690674369458076,unbeliever,630,2403,3033
-0.0739725418719317,3.333777290640384,unionist,11967,7396,19363
2.710963916256116,2.3075564507389252,user,607411,799952,1407363
1.711509544334909,2.900999258620658,vacationer,148,1255,1403
1.2677449261083424,3.010675049261053,vassal,3515,2024,5539
0.7338932241379581,2.6630342758620884,veteran,213943,170551,384494
1.6607022019703983,2.341876960591126,victim,271100,366143,637243
2.3412871921182123,3.692384766009827,victor,66979,3566,70545
2.2482073497537094,2.9777965812808134,viewer,44091,140540,184631
1.5639244310344935,3.2555322512314255,villain,42564,27904,70468
1.4123623275862194,2.8431591625615873,visitor,41692,162009,203701
0.975516938423624,3.0491272536946212,volunteer,97390,115630,213020
2.3285075935960506,2.9873416798029453,voyager,16471,1146,17617
1.5446775566502673,2.8068070935960634,walker,133753,9551,143304
2.1601750221674614,2.7362427463054217,wanderer,2932,9060,11992
0.8190376896552394,3.2501759162561967,warmonger,1082,1394,2476
1.528866839901486,3.099500716748743,warrior,61742,100220,161962
0.40369308374383905,2.7225028793103263,washer,4666,2466,7132
1.248016635467998,2.9725086773399205,wasp,9809,7184,16993
1.7462700344827624,3.312292251231451,watcher,5626,14120,19746
1.9150171133004505,2.697825955665003,waterman,1756,370,2126
0.3430463177340144,3.654966317733944,waver,2382,854,3236
1.778651963054223,2.94233562807889,westerner,1642,11961,13603
0.9503692216749364,3.1838732586206326,whale,50883,37849,88732
2.1341796034482208,3.288202083743805,winner,192575,95521,288096
1.6099984605911857,3.8478750098522276,wiper,2178,1507,3685
1.4985134334975214,3.0055744630541916,witch,50698,13796,64494
1.1077259433497204,2.8500419630541707,witness,166055,123495,289550
2.1522482561576055,3.213528948275819,wizard,40268,50075,90343
2.5403602044334868,2.5345233817734076,woman,942412,1843952,2786364
2.038132209359617,3.0880527709360415,worker,175313,755287,930600
1.7136309408867234,3.1695476502462583,workmate,215,672,887
3.162380044334988,3.357812012315428,worshiper,638,3727,4365
3.196039379310335,3.5456929482758675,worshipper,1261,7898,9159
2.0191675344827615,3.365906413793077,wrestler,20026,15836,35862
2.6543627783251047,3.197432876847266,writer,293224,186923,480147
2.272828487684638,3.3850323645320657,wrongdoer,402,1190,1592
2.192477179802907,3.2482158990147383,youngster,16268,25665,41933
0.07076910344823872,2.992740674876824,youth,277574,28938,306512
0.8241215862068465,3.125736475369415,zealot,4735,7341,12076
0.4767248152708703,3.6541437980296188,zombie,67293,36298,103591
1.529104598522153,3.295714766009837,zooid,52,119,171
